english	hindi
Aabheer	आभीर
Aachman	आचमन
Aadarsh	आदर्श
Aadesh	आदेश
Aadhira	आधिरा
Aadi	आदि
Aadidev	आदिदेव
Aadil	आदिल
Aadinath	आदिनाथ
Aadit	आदित
Aaditeya	आदितेय
Aaditya	आदित्य
Aafreen	आफ्रीन
Aagam	आगम
Aagney	आग्नेय
Aagneya	आग्नेय
Aahlaad	आहलाद
Aahva	आहवा
Aakar	आकर
Aakarshan	आकर्षण
Aakash	आकाश
Aalam	आलम
Aalap	आलाप
Aalok	आलोक
Aamir	आमिर
Aamod	आमोद
Aanand	आनंद
Aanandswarup	आनंदस्वरूप
Aandaleeb	आनदालीब
Aanjaneya	आंजनेय
Aapt	आप्त
Aaradhak	आराधक
Aarif	आरिफ
Aariz	आरिज़
Aashish	आशीष
Aasim	आसिम
Aatreya	आत्रेय
Aayu	आयु
Aayushman	आयुष्मान
Abaan	अबान
Abbas	अब्बास
Abdul	अब्दुल
Abdul-Azeez	अब्दुल-अज़ीज़
Abdul-Baari	अब्दुल-बारी
Abdul-Ghafoor	अब्दुल-घाफूर
Abdul-Hafiz	अब्दुल-हाफिज़
Abdul-Hameed	अब्दुल-हमीद
Abdul-Haseeb	अब्दुल-हसीब
Abdul-Jabar	अब्दुल-जबार
Abdul-Jaleel	अब्दुल-जलील
Abdul-Khaliq	अब्दुल-खालिक
Abdullah	अब्दुल्लाह
Abdul-Qadir	अब्दुल-कादिर
Abdul-Qahaar	अब्दुल-कहार
Abdul-Qudoos	अब्दुल-कुदूस
Abdul-Raheem	अब्दुल-रहीम
Abdul-Raouf	अब्दुल-रौफ
Abdul-Rasheed	अब्दुल-रशीद
Abdul-Razaaq	अब्दुल-रजाक
Abdul-Salaam	अब्दुल-सलाम
Abdul-Waahid	अब्दुल-वाहिद
Abdul-Wadood	अब्दुल-वादूद
Abed	आबेद
Abedin	आबेदीन
Abeer	अबीर
Abhay	अभय
Abhayananda	अभयानंदा
Abhayaprada	अभयप्रदा
Abheek	अभीक़
Abhi	अभी
Abhibhava	अभिभवा
Abhicandra	अभिकांद्र
Abhidi	अभीदी
Abhihita	अभिहीता
Abhijat	अभिजात
Abhijay	अभिजय
Abhijaya	अभिजया
Abhijit	अभिजीत
Abhijvala	अभिज्वाला
Abhik	अभिक
Abhilash	अभिलाश
Abhimand	अभिमंद
Abhimani	अभिमानी
Abhimanyu	अभिमन्यु
Abhimanyusuta	अभिमन्यूसुता
Abhimoda	अभिमोदा
Abhinabhas	अभिनभस
Abhinanda	अभिनंदा
Abhinandan	अभिनन्दन
Abhinandana	अभिनंदना
Abhinatha	अभिनाथा
Abhinav	अभिनव
Abhinava	अभिनवा
Abhinivesh	अभिनिवेश
Abhiraj	अभिराज
Abhiram	अभिराम
Abhirath	अभिरथ
Abhirup	अभिरूप
Abhisar	अभिसार
Abhishek	अभिषेक
Abhisoka	अभिसोका
Abhisumat	अभिसुमत
Abhisyanta	अभिस्यनता
Abhivadan	अभिवादन
Abhivanth	अभिवंथ
Abhivira	अभिवीरा
Abhra	अभरा
Abhrakasin	अभ्रकासिन
Abhyagni	अभ्याग्नी
Abhyudaya	अभ्युदया
Abhyudita	अभ्युदिता
Abid	आबिद
Abjayoni	अब्जायोनी
Abjit	अब्जित
Abu Bakr	अबू बक्र
Abul Khayr	अबुल खेर
Acalapati	अकालपति
Acalendra	अकालेंद्र
Acalesvara	अकालेस्वरा
Acanda	अकांदा
Acarya	अकार्या
Acaryanandana	अकार्यानंदना
Acaryasuta	अकार्यसुता
Acaryatanaya	अकार्यतान्या
Acchindra	अच्चिन्द्र
Achal	अचल
Achalendra	अचलेंद्र
Achalraj	अचलराज
Achintya	अचिंत्य
Achyut	अच्युत
Achyuta	अच्युता
Achyuthan	अच्युथन
Acintya	अचिंत्य
Acyutaraya	अच्युतराया
Adalarasu	अदालरासू
Adarsh	आदर्श
Adeep	अदीप
Adesh	आदेश
Adham	अदहम
Adheer	अधीर
Adheesh	अधीश
Adhik	अधिक
Adhikara	अधिकरा
Adhip	अधिप
Adhipa	अधिपा
Adhiraj	अधिराज
Adhita	अधिता
Adikavi	आदिकवि
Adil	आदिल
Adinath	आदिनाथ
Adipurush	आदिपुरुष
Adit	आदित
Aditeya	आदितेया
Aditya	आदित्य
Adityanandana	आदित्यानंदना
Adityavardhana	आदित्यावर्धाना
Adnan	अदनान
Adripathi	अद्रिपथी
Advait	अद्वेत
Advay	अद्वय
Advaya	अद्वाया
Advik	अद्विक
Adwaita	अद्वैता
Adway	अदवय
Adwaya	अदवाया
Afeef	अफीफ
Aftab	आफ़ताब
Afzal	अफ़ज़ल
Agamjeet	अगमजीत
Agampreet	अगम्प्रीत
Agasti	अगस्ती
Agastya	अगस्त्य
Agendra	अगेन्द्र
Agha	अगा
Agharna	अघरना
Aghat	आघात
Aghosh	अघोष
Agneya	अग्नेया
Agnikumara	अग्निकुमारा
Agnimitra	अग्निमित्र
Agniprava	अग्नीप्रवा
Agnivesh	अग्निवेश
Agraj	अग्रज
Agrim	अग्रिम
Agriya	अग्रिया
Agyeya	अज्ञेय
Ahan	अहन
Ahijit	अहिजित
Ahilan	आहिलन
Ahmad	अहमद
Ahsan	अहसान
Aijaz	ऐजाज़
Aiman	ऐमन
Ainesh	आइनेश
Airawat	ऐरावत
Aja	अजा
Ajaipal	अजैपल
Ajamil	अजामिल
Ajat	अजात
Ajatashatru	अजातशत्रु
Ajatshatru	अजातशत्रु
Ajay	अजय
Ajinkya	अजिंक्य
Ajit	अजित
Ajitabh	अजीताभ
Ajitesh	अज़ितेश
Ajmal	अजमल
Ajoy	अजोय
Akaldeep	अकालदीप
Akalmash	अकालमश
Akalpa	अकल्पा
Akalpreet	अकालप्रीत
Akand	अकंद
Akarsh	आकर्ष
Akash	आकाश
Akhil	अखिल
Akhilesh	अखिलेश
Akmal	अकमल
Akram	अक्रम
Akroor	अक्रूर
Akshaj	अक्शाज
Akshan	अक्षण
Akshansh	अक्षांश
Akshar	अक्षर
Akshat	अक्षत
Akshath	अक्षथ
Akshay	अक्षय
Akshayaguna	अक्षयागुना
Akshaykeerti	अक्षय्कीर्ती
Akshit	अक्षित
Akshobhya	अक्षोभ्य
Akul	अकूल
Al Abbas	अल अब्बास
Alaa	अला
Alaa Udeen	अला उदीन
Alagan	अलगन
Alagarasu	अलगरासू
Alak	अलक
Alamgir	आलमगिर
Alankar	अलंकार
Alhad	अल्हद
Ali	अली
Alibaba	अलीबाबा
Alif	अलिफ
Alok	आलोक
Aloke	अलोके
Aloki	अलोकी
Alop	अलोप
Alpesh	अल्पेश
Amal	अमल
Amalendu	अमलेंदु
Amalesh	अमलेश
Aman	अमान
Amanath	अमानत
Amanda	आमंदा
Amanjeet	अमनजीत
Amanpal	अमनपाल
Amanveer	अमनवीर
Amar	अमर
Amardeep	अमरदीप
Amaresh	अमरेश
Amaris	अमरिस
Amarjeet	अमरजीत
Amarnath	अमरनाथ
Amarpreet	अमरप्रीत
Amartya	आमर्त्य
Ambar	अंबर
Ambareesh	अम्बरीश
Ambarish	अम्बरीश
Ambikapathi	अम्बिकापथी
Ambud	अम्बुद
Ambuj	अँबुज
Ameen	अमीन
Ameer	अमीर
Ameya	अमेया
Ameyatma	अमेयत्मा
Amian	अमियन
Amil	अमिल
Amir	आमिर
Amish	अमीश
Amit	अमित
Amitabh	अमिताभ
Amitav	अमिताभा
Amitava	अमितवा
Amitbikram	अमितबीक्रम
Amitesh	अमितेश
Amitiyoti	अमितीयोती
Amitrasudan	अमित्रसुदन
Amiya	अमिया
Amjad	अमजद
Amlah	अम्लाह
Amlan	अम्लान
Amlankusum	अम्लान्कुसुम
Ammar	अम्मार
Amod	अमोद
Amogh	अमोघ
Amoha	अमोहा
Amol	अमोल
Amolak	अमॉलिक
Amolik	अमॉलिक
Amoorta	अमूर्त
Amr	अमर
Amresh	अमरेश
Amrik	अमरीक
Amrinder	अमरिंदर
Amrish	अमरीश
Amrit	अमृत
Amrit	अमृत
Amritambu	अम्रिताम्बू
Amritaya	अम्रिताया
Amshu	अम्शु
Amshul	अम्शुल
Amul	अमुल
Amulya	अमूल्य
Anadi	अनाडी
Anagh	अनघ
Anahid	अनाहिद
Anamitra	अनामीत्रा
Anand	आनंदा
Ananda	आनंदा
Anang	अनंगा
Ananmaya	अञन्मया
Anant	अनंत
Ananta	अनंता
Anantajeet	अनंताजीत
Anantram	अनंतराम
Ananyo	अनन्यो
Anarghya	अनार्घ्या
Anas	अनस
Anay	अन्य
Anbarasu	अंबरसू
Anbu	अंबू
Anbuchelvan	अंबूचेलवान
Anbumadi	अंबूमड़ी
Anees	अनीस
Anek	अनेक
Angad	अंगद
Angada	अंगादा
Angaj	अन्गाज
Angak	अन्गाक
Angamuthu	अन्गामुथूं
Aniij	अनीज
Anik	अनिक
Anikait	अनिकेत
Aniket	अनिकेत
Anil	अनिल
Anilabh	अनिलाभ
Animesh	अनिमिष
Aniruddha	अनिरुद्ध
Anirudh	अनिरुद्ध
Anirudhha	अनिरूध
Anirvan	अनिर्वाण
Anisa	अनीसा
Anish	अनीश
Anit	अनित
Aniteja	अनितेज़ा
Anjal	अंजल
Anjan	अंजन
Anjas	अंजस
Anjasa	अंजासा
Anjor	अंजोर
Anjum	अंजुम
Anjuman	अंजुमन
Ankal	अंकल
Ankit	अंकित
Ankur	अंकुर
Ankush	अंकुश
Anmol	अनमोल
Anna	अन्ना
Annuabhuj	अन्नुअभुज
Anoop	अनूप
Anoopjot	अनूपजोत
Anram	अनरम
Ansh	अंश
Anshu	अंशु
Anshuk	अंशुक
Anshul	अंशुल
Anshuman	अंशुमान
Anshumat	अंशुमात
Antariksh	अंतरिक्ष
Antim	अंतिम
Anu	अनु
Anugya	अनुगया
Anuha	अनुह
Anuj	अनुज
Anunay	अनुनाय
Anup	अनूप
Anupam	अनुपम
Anurag	अनुराग
Anuttam	अनुत्तम
Anwar	अनवर
Apoorva	अपूर्वा
Apparajito	अप्पराजीतो
Aprameya	अप्रमेय
Aranab	अरनाब
Arav	अरव
Aravali	अरवाली
Aravan	अरावन
Arbad	अर्बाद
Archan	अर्चन
Archit	अर्चित
Ardhendu	अरधेंदु
Areehah	अरीहः
Arghya	अरघ्या
Arha	अर्ह
Arham	अरहम
Arhant	अरहंत
Arhat	अर्हत
Arihan	अरिहन
Arihant	अरिहंत
Arij	अरिज
Arijit	अरिजीत
Arindam	अरिंदम
Arivalagan	अरिवालगन
Arivali	अरीवाली
Arivarasu	अरिवारासू
Arivoli	अरिवोली
Arivuchelvan	अरिवुचेल्वन
Arivumadhi	अरीवुमाधी
Arivumani	अरिवुमानी
Arivunambi	अरिवुनाम्बी
Arja	अर्ज
Arjit	अर्जित
Arjun	अर्जुन
Arka	आरका
Arkaan	अरकान
Arman	अरमान
Arman	अरमान
Arnav	अर्नव
Arnesh	अर्नेश
Arokya	अरोक्य
Arpan	अर्पण
Arsh	अर्श
Arshad	अर्शद
Artagnan	अर्ताग्नन
Arth	आर्थ
Arul	अरूल
Arulchelvan	अरुलचेलवान
Arumugan	आरुमुगान
Arun	अरुण
Arunachaleshwara	अरुनाचलेश्वारा
Aruni	अरुनी
Arunjeet	अरुनजीत
Arvind	अरविंद
Arvinda	अरविंदा
Arya	आर्या
Aryaman	आर्यमान
Aryan	आर्यन
Asav	आसाओ
Aseem	असीम
Asgar	असग़र
Ashcharya	आश्चर्य
Asheem	अशीम
Ashesh	आशेश
Ashfaq	अशफाक
Ashirvad	आशीर्वाद
Ashis	आशिस
Ashish	आशीष
Ashit	असित
Ashlesh	आश्लेश
Ashman	आशमान
Ashok	अशोक
Ashraf	अशरफ़
Ashray	आश्रय
Ashu	आशू
Ashutosh	आशुतोष
Ashvath	अश्वथ
Ashvin	अश्विन
Ashwaghosh	अश्वघोष
Ashwatthama	अश्वत्थामा
Ashwin	अश्विन
Ashwini	अश्विनी
Asif	आसिफ
Asit	असित
Asitvaran	असित्वरण
Aslesh	असलेश
Astik	आस्तिक
Asuman	असुमान
Asvin	अश्विन
Ataa	अता
Atal	अटल
Atambhu	अताम्भु
Atamveer	अतमवीर
Atanu	अतानु
Ateet	अतीत
Atharvan	अथर्वन
Atif	आतिफ
Atiksh	अतिक्ष
Atish	आतिश
Atithi	अतिथि
Atiya	अतिया
Atma	आत्मा
Atmaj	आत्मज
Atmaja	आत्मजा
Atmajyoti	आत्मज्योति
Atman	आत्मन
Atmananda	आत्मनंदा
Atraiu	अत्रेऊ
Atralarasu	अत्रलारासु
Atreya	आतरेया
Atul	अतुल
Atulya	अतुल्या
Avadhesh	अवधेश
Avalok	अवलोक
Avanindra	अवनिन्द्र
Avanish	अवनीश
Avashesh	अवशेष
Avasyu	अवस्यु
Avatar	अवतार
Avi	अवि
Avichal	अविचल
Avijit	अविजित
Avikam	अविकम
Avikshit	अवीक्षित
Avilash	अविलाश
Avinash	अविनाश
Avinashi	अविनाशी
Avirat	अविरत
Avkash	अवकाश
Avtar	अवतार
Avyukta	अव्युकता
Awad	आवाद
Aws	अवस
Ayaaz	अयाज़
Ayman	अयमान
Ayog	आयोग
Ayoob	अयूब
Ayush	आयुष
Ayushman	आयुष्मान
Ayyapan	अय्यपन
Azam	अज़म
Azb	अज़्ब
Azhar	अजहर
Azhmeer	अज्ह्मीर
Azzaam	अज्जाम
Aabha	आभा
Aabharana	आभरण
Aadab	आदाब
Aadarshini	आदर्शिनी
Aadhya	आध्या
Aadita	आदिता
Aadrika	आद्रिका
Aahladita	आहलादिता
Aahna	आह्ना
Aakanksha	आकांक्षा
Aalia	आलिया
Aaliya	आलिया
Aamaal	आमाल
Aaoka	आलोका
Aapti	आप्ति
Aaratrika	आरात्रिका
Aarini	आरिनी
Aarna	आर्ना
Aarti	आरती
Aashalata	आशालता
Aashi	आशी
Aashika	आशिका
Aashiyana	आशियाना
Aashna	आष्ना
Aashni	आष्नी
Aashritha	आश्रिता
Aasia	आसिया
Aasmaa	आसमा
Aastha	आस्था
Aathmika	आथ्मिका
Aatikah	आतिकः
Aatmaja	आत्मजा
Aayushi	आयुशी
Abeer	अबीर
Abha	आभा
Abhati	अभाती
Abhaya	अभया
Abhidha	अभीधा
Abhidhya	अभीध्या
Abhijata	अभिजात
Abhijita	अभिजीता
Abhijna	अभीज्ना
Abhilasa	अभिलासा
Abhilasha	अभिलाशा
Abhinithi	अभिनीति
Abhiprithi	अभिप्रिथि
Abhira	अभिरा
Abhirami	अभिरामी
Abhirathi	अभिरथी
Abhiri	अभिरी
Abhiruchi	अभिरुचि
Abhirupa	अभिरुपा
Abhisarika	अभिसारिका
Abhisri	अभीश्री
Abhitha	अभिथा
Abhithi	अभिथि
Abidah	अबिदः
Abirami	अबिरामी
Abishta	अबिष्ट
Abja	अब्जा
Ablaa	अबला
Aboil	अबोइल
Aboli	अबोली
Achala	अचला
Achira	अचिरा
Achit	अचित
Achla	अचला
Acira	असिरा
Adarsha	आदर्शा
Adeela	अदीला
Adhira	अधीरा
Adhishree	अधिष्री
Adi-Shakti	आदि-शक्ति
Adishree	अदिश्री
Aditha	अदिथा
Adithi	अदिथि
Aditi	अदिति
Aditri	अदित्री
Adrija	अद्रिजा
Adrika	अद्रिका
Adrisa	अद्रिसा
Advika	अद्विका
Adwita	अद्विता
Adwiteya	अद्वितेया
Adwitiya	अद्वितीय
Adya	आद्या
Aesha	ऐषा
Afaf	अफफ
Afraa	अफरा
Afrah	अफ्रह
Afroza	अफ्रोज़ा
Agamya	अगम्य
Aghanashini	अघनाशिनी
Agnishikha	अग्निशिखा
Agrata	अग्रता
Agrima	अग्रीमा
Ahalya	अहल्या
Ahd	अहद
Ahilya	अहिल्या
Ahimsa	अहिंसा
Ahladita	अहलादिता
Ahladitha	अहलादिथा
Ahlam	अह्लम
Aida	इदा
Aisha	एषा
Aishani	ऐशानी
Aishi	ऐशी
Aishwarya	ऐश्वर्या
Aja	अजा
Ajaa	अजा
Ajagandha	अजगंधा
Ajala	अज़ला
Ajanta	अजन्ता
Ajastha	अजस्था
Ajeeta	अजीता
Ajinder	अजिंदर
Ajita	अजीता
Akalka	अकालका
Akane	अकाने
Akanksha	आकांक्षा
Akashleena	आकाशलीना
Akhila	अखिला
Akira	अकीरा
Aklima	अक्लिमा
Akriti	आकृति
Akshadha	अक्षधा
Akshara	अक्षरा
Akshata	अक्षता
Akshaya	अक्षया
Akshi	अक्षी
Akshita	अक्षिता
Akshiti	अक्षिति
Aksithi	अक्सिथी
Akula	अकुला
Akuti	अकुती
Alaina	अलैना
Alak	अलक
Alaka	अलका
Alaka	अलका
Alakananda	अलकनंदा
Alaknanda	अलकनंदा
Alankrita	अलंक्रिता
Alda	अल्दा
Alekhya	अलेख्या
Alia	अलिया
Alisha	अलीशा
Aliza	अलीजा
Alka	अल्का
Allanna	अल्लान्ना
Almas	अल्मस
Aloki	अलोकी
Alopa	आलोपा
Alpa	अल्पा
Alpana	अल्पना
Alpita	अल्पिता
Altthea	अल्त्ठेया
Amala	अमला
Amaldeepti	अमलदीप्ती
Amani	आमानी
Amani	अमानी
Amara	अमरा
Amari	अमारी
Amaris	अमरिस
Amarta	अमरता
Amatullah	अमातुल्लाह
Amba	अंबा
Ambalika	अंबालिका
Amberley	अम्बेरली
Ambika	अंबिका
Ambu	अंबू
Ambuda	अंबुडा
Ambuja	अँबुजा
Ameena	अमीना
Ameera	अमीरा
Ami	अमी
Amidi	अमिदी
Amisha	अमीषा
Amishi	अमिशी
Amishta	अमिष्ता
Amita	अमिता
Amithi	अमिति
Amiti	अमिति
Amitjyoti	अमितज्योती
Amiya	अमिया
Amla	अम्ला
Amlika	अम्लिका
Amoda	अमोदा
Amodini	अमोदिनी
Amolika	अमोलिका
Amoolya	अमूल्या
Amrapali	आम्रपाली
Amrita	अमृता
Amritambu	अम्रिताम्बू
Amritkala	अमृतकला
Amrusha	अमृशा
Amrutha	अमृता
Amshula	अंशुला
Amukta	अमुक्त
Amulya	अमुल्या
Amvi	अम्वी
Ana	आना
Anaan	अनान
Anagha	अनाघा
Anagi	अनागी
Anahita	अनाहिता
Anal	अनल
Anala	अनला
Anamika	अनामिका
Ananda	आनंदा
Anandalakshmi	आनंदालक्ष्मी
Anandamaye	आनंदमयी
Anandamayi	आनंदमयी
Anandani	अनंदानी
Anandi	आनंदी
Anandini	आनंदिनी
Anandita	आनंदिता
Anandmayee	आनंदमयी
Anangee	अनंगी
Ananta	अनंता
Anantha	अनंता
Ananti	अनंती
Anantya	अनंता
Ananya	अनन्या
Anarghya	अनार्घ्या
Anasuya	अनसूया
Anathi	अनथी
Anavi	अनवी
Anbar	अंबर
Anchal	आँचल
Anchala	अंचला
Anchita	अंचिता
Aneesa	अनीसा
Anemone	अनेमोने
Angaja	अंगाजा
Angana	अंगना
Angarika	अंगारिका
Angha	अनघ
Angira	अंगिरा
Angoori	अंगूरी
Anhithi	अनहिति
Ania	अनिया
Aniha	अनिहा
Anika	अनीका
Anilaja	अनीलजा
Anima	अनिमा
Anindita	अनिंदिता
Aninditha	अनिंदिथा
Anisha	अनिशा
Anishka	अनिश्का
Anita	अनीता
Aniya	अनिया
Anjali	अंजली
Anjalika	अंजलिका
Anjana	अंजना
Anjani	अंजनी
Anjika	अंजिका
Anjini	अंजिनी
Anju	अंजू
Anjushri	अंजूश्री
Ankal	अंकल
Ankita	अंकिता
Ankitha	अंकिता
Ankolika	अंकोलिका
Anna	अन्ना
Annada	अंनदा
Annapoorna	अन्नपूर्णा
Annapurna	अन्नपूर्णा
Annika	अन्निका
Annisa	अन्निसा
Annjaya	अन्न्जय
Anokhi	अनोखी
Ansha	अन्षा
Anshi	अंशी
Anshika	अन्शिका
Anshita	अन्शिता
Anshula	अंशुला
Anshumala	अन्शुमाला
Anshumali	अंशुमाली
Ansuya	अन्सुया
Antara	अंतरा
Antariksha	अंतरिक्ष
Antini	अंतिनी
Anubhuti	अनुभूति
Anudeepthi	अनुदीप्थी
Anuga	अनुगा
Anugraha	अनुग्रहा
Anuja	अनुजा
Anukampa	अनुकम्पा
Anukeertana	अनुकीरताना
Anukriti	अनुकृति
Anula	अनुला
Anulata	अनुलाता
Anulekha	अनुलेखा
Anuloma	अनुलोमा
Anumati	अनुमति
Anumegha	अनुमेघा
Anumeha	अनुमेहा
Anumita	अनुमिता
Anunitha	अनूनिता
Anupa	अनुपा
Anupama	अनुपमा
Anuprabha	अनुप्रभा
Anupriya	अनुप्रिया
Anuradha	अनुराधा
Anuragini	अनुरागिनी
Anurati	अनुरती
Anusha	अनुशा
Anushka	अनुष्का
Anushri	अनुश्री
Anusri	अनुश्री
Anusuya	अनुसुया
Anuttara	अनुत्तारा
Anuva	अनुवा
Anvi	अन्वी
Anvita	अन्विता
Anwaar	अनवार
Anwesha	अन्वेशा
Anwita	अन्विता
Anya	अन्या
Aolani	ओलानी
Apala	अपला
Apara	अपरा
Aparajita	अपराजिता
Aparijita	अपरिजिता
Aparna	अपर्णा
Aparoopa	अपारूपा
Apeksha	अपेक्षा
Apinaya	अपिनाया
Apsara	अप्सरा
Apurba	अपुरबा
Apurva	अपूर्व
Aqilah	अकिलाह
Aqsa	अक्सा
Araceli	अरासेली
Aradhana	आराधना
Arathi	अरथी
Arati	आरती
Archa	अर्चा
Archan	अर्चन
Archana	अर्चना
Archini	अर्चिनी
Archisha	अर्चिषा
Archita	अर्चिता
Ardra	आर्द्र
Areebah	अरीबाह
Areej	अरीज
Arianna	अरिअन्ना
Arij	अरिज
Ariktha	अरिक्था
Ariona	अरिओना
Arja	अर्ज
Arjuni	अर्जुनी
Arkita	अर्किता
Armin	अर्मिन
Armita	अर्मिता
Arni	अरनी
Arogyada	अरोग्यदा
Arohi	आरोही
Aroob	अरूब
Arpana	अर्पना
Arpita	अर्पिता
Arshia	अर्शिया
Arshiya	अर्शिया
Artana	अर्ताना
Arti	आरती
Aruna	अरुणा
Arundhathi	अरुंधथी
Arundhati	अरुंधती
Aruni	अरुनी
Arunima	अऋुणिमा
Arushi	अऋषि
Arwa	अरवा
Aryahi	अर्याही
Aryama	अर्यामा
Aryana	अर्याना
Asah	असह
Asalah	असलाह
Asarat	असरत
Asavari	असावरी
Aseelah	असीलाह
Aseema	असीमा
Asfaq	अस्फक
Asgari	असग़री
Asha	आशा
Ashakiran	आशाकिरण
Ashalata	आशालता
Ashani	अशनी
Ashavari	आशावारी
Ashfina	अश्फिना
Ashika	अशिका
Ashima	अशिमा
Ashiqa	अशिका
Ashira	अशिरा
Ashis	अशिस
Ashita	अशिता
Ashlesha	आश्लेषा
Ashley	अश्लेय
Ashmi	अश्मी
Ashmita	अश्मिता
Ashmiza	अश्मिज़ा
Ashna	अशना
Ashoka	अशोका
Ashrita	आश्रिता
Ashritha	आश्रिता
Ashwabha	अश्वाभा
Ashwina	अश्विना
Ashwini	अश्विनी
Asita	असीता
Asiya	आसिया
Askini	अस्किनी
Aslesha	आस्लेशा
Asma	आस्मा
Asmita	अस्मिता
Astha	आस्था
Asvika	अस्विका
Aswathi	अस्वथी
Asya	अस्या
Atasi	अतासी
Athalia	अथालिया
Athasha	अथाषा
Atheeva	अथीवा
Atif	आतिफ
Atiriya	अतीरिया
Atmaja	आत्मजा
Atmikha	अत्मिखा
Atreyi	अत्रेयी
Atula	अतुला
Auhna	औहना
Avani	अवनी
Avanija	अवानीजा
Avanti	अवंती
Avantika	अवंतिका
Avapya	अवाप्या
Avasa	अवसा
Avigna	अविग्ना
Avinashi	अविनाशी
Avinashika	अविनाशिका
Avipsa	अविप्सा
Avishi	अविशी
Avni	अवनि
Avnita	अवनिता
Ayanna	अयान्ना
Ayati	अयती
Ayeh	एह
Ayesha	आयेशा
Ayurda	अयुर्दा
Ayushi	अयुशी
Ayushmati	आयुश्मति
Azeeza	अजीज़ा
Azhaar	अज्हार
Azmina	अज्मिना
Azza	अज्ज़ा
Baahir	बाहिर
Baasim	बासिम
Babala	बबला
Babul	बाबुल
Badal	बादल
Badr Udeen	बद्र उदीन
Badri	बद्री
Badrinath	बद्रीनाथ
Badriprasad	बद्रीप्रसाद
Baha	बहा
Baha Udeen	बहा उदीन
Bahiy Udeen	बहीय उदीन
Bahubali	बाहुबली
Bahula	बहुला
Bahuleya	बाहुलेया
Bahumanya	बाहूमान्य
Bahurai	बहुराई
Bajrang	बजरंग
Bakhtawar	बख्तावर
Bakool	बकूल
Bakul	बकुल
Balaark	बालार्क
Balachandra	बालचंद्रा
Balachandrav	बालचंद्रव
Baladhi	बालधि
Baladhitya	बालाधित्य
Baladitya	बालादित्य
Balagopal	बालगोपाल
Balagovind	बालागोविंद
Balaji	बालाजी
Balakrishna	बालाकृष्णा
Balakumar	बालकुमार
Balamani	बालामानी
Balamohan	बालामोहन
Balamurugan	बालामुरुगन
Balan	बालन
Balanath	बालनाथ
Balaraj	बालाराज
Balaram	बालाराम
Balaravi	बालारवी
Balashankar	बालाशंकर
Balavan	बलवान
Balavant	बलवंत
Balbhadra	बलभद्र
Balbir	बलबीर
Balbir	बलबीर
Baldev	बलदेव
Balendra	बालेन्द्र
Balendu	बालेन्दु
Balgopal	बालगोपाल
Bali	बाली
Balkrishan	बालक्रिशन
Balraj	बलराज
Balram	बलराम
Balvant	बलवंत
Balveer	बलवीर
Balvinder	बलविंदर
Balvinder	बलविंद्रा
Balvindra	बल्विन्द्र
Balwant	बलवंत
Balwant	बलवंत
Banaj	बनज
Banbhatt	बानभात्त
Banbihari	बनबिहारी
Bandhu	बंधु
Bandhul	बंधूल
Bandhula	बंधुला
Baneet	बनीत
Banke	बांके
Banke Bihari	बांके बिहारी
Bankebihari	बांकेबिहारी
Bankim	बनकीम
Bankimchandra	बंकिमचंद्र
Banshi	बंशी
Banshidhar	बंशीधर
Bansi	बंसी
Bansilal	बंसीलाल
Banwari	बनवारी
Barid	बरिद
Baridbaran	बरिदबरण
Barindra	बरिंद्रा
Barindra	बरिन्द्र
Barsat	बरसात
Barun	बरुन
Basaam	बसाम
Basant	बसंत
Basanta	बसंता
Basavaraj	बसवराज
Basel	बसेल
Bashaar	बशार
Bashir	बशीर
Basistha	बसिस्ता
Basudev	बासुदेव
Basudha	बसूधा
Batuk	बटुक
Bhadra	भद्र
Bhadrak	भद्रक
Bhadrakapil	भद्रकपिल
Bhadraksh	भद्रक्ष
Bhadrang	भद्रंग
Bhadranidhi	भद्रनिधि
Bhadrashree	भद्रश्री
Bhadresh	भद्रेश
Bhagaditya	भगदित्य
Bhagat	भगत
Bhagavan	भगवान
Bhagesh	भागेश
Bhagirat	भागिरत
Bhagirath	भागीरथ
Bhagwant	भगवंत
Bhagyanandana	भाग्यनंदाना
Bhagyaraj	भाग्याराज
Bhairav	भैरव
Bhajan	भजन
Bhakti	भक्ति
Bhalendra	भालेंद्र
Bhanu	भानु
Bhanudas	भानुदास
Bhanumitra	भानुमित्र
Bhanuprakash	भानुप्रकाश
Bhanuprasad	भानुप्रसाद
Bharadwaj	भारद्वाज
Bharat	भारत
Bhargav	भार्गव
Bhargava	भार्गवा
Bhargyaraj	भार्ग्यराज
Bhartesh	भर्तेश
Bhartihari	भार्तिहारी
Bhaskar	भास्कर
Bhasvan	भास्वन
Bhaswar	भास्वर
Bhaumik	भौमिक
Bhavamanyu	भावामन्यु
Bhavan	भवन
Bhav-bhooti	भव-भूति
Bhavesh	भावेश
Bhavin	भविन
Bhawanidas	भवानिदास
Bheru	भेरू
Bhim	भीम
Bhimsen	भीमसेन
Bhisham	भीषम
Bhishma	भीष्मा
Bhoj	भोज
Bhojaraja	भोजराजा
Bholanath	भोलानाथ
Bhoopat	भूपत
Bhoopendra	भूपेन्द्र
Bhooshan	भूषण
Bhooshit	भूषित
Bhoumik	भौमिक
Bhramar	भ्रमर
Bhrigu	भृगु
Bhudev	भूदेव
Bhuman	भुमन
Bhumi	भूमि
Bhupad	भुपद
Bhupal	भूपाल
Bhupathi	भूपति
Bhupati	भूपति
Bhupen	भूपेन
Bhupendra	भुपेन्द्र
Bhupesh	भूपेश
Bhupinderpal	भूपिंदरपाल
Bhushan	भूषण
Bhuvan	भुवन
Bhuvanesh	भुवनेश
Bhuvaneshwar	भुवनेश्वर
Bibek	बिबेक़
Bibhas	बिभस
Bibhavasu	बिभवासु
Bijal	बिज़ल
Bikram	बिक्रम
Bilal	बिलाल
Bilva	बिल्वा
Bimal	बिमल
Bimb	बिम्ब
Bimbisar	बिम्बिसार
Bindusar	बिंदूसर
Bipin	बिपिन
Bir	बीर
Birbal	बीरबल
Biren	बिरेन
Birendra	बीरेन्द्र
Birju	बिरजू
Bisaj	बिसज
Bishanpal	बिशनपाल
Bishr	बिश्र
Bismeet	बिस्मीत
Bitasok	बितासोक
Bodhan	बोधन
Boudhayan	बौधायन
Brahamjeet	ब्रहाम्जीत
Brahma	ब्रह्मा
Brahmabrata	ब्रह्मब्रता
Brahmadutt	ब्रह्मदुत्त
Brahmanand	ब्रह्मानंद
Braj	ब्रज
Brajamohan	ब्रजमोहन
Brajendra	ब्रजेन्द्र
Brajesh	ब्रजेश
Brajraj	ब्रजराज
Bramhaghosh	ब्रम्हाघोश
Bramhanand	ब्रम्हानंद
Bratindra	ब्रतिन्द्र
Brent	ब्रेन्त
Brij	ब्रिज
Brijender	ब्रिजेंदर
Brijesh	ब्रीजेश
Brijkishor	ब्रिजकिशोर
Brijmohan	ब्रिजमोहन
Brijnandan	ब्रिजनंदन
Brijraj	ब्रिजराज
Brirar	ब्रिरार
Buddha	बुद्धा
Buddhadev	बुद्धदेव
Buddhadeva	बुद्धदेवा
Buddhapriya	बुद्धाप्रिया
Budhil	बुधिल
Bukka	बूक्का
Burhan	बुरहान
Baasima	बासिमा
Babita	बबिता
Badriya	बदरिया
Bageshri	बागेश्री
Baheera	बहीर
Bahiyaa	बहिया
Bahugandha	बहुगंधा
Bahula	बहुला
Baijanti	बैजंती
Bairavi	बैरावी
Baka	बका
Bakul	बकुल
Bakula	बकुला
Bala	बाला
Balqis	बल्किस
Banan	बनान
Bandhavi	बंधावी
Bandhura	बंधुरा
Banhi	बन्ही
Bani	बानी
Banmala	बनमाला
Banni	बन्नी
Bansari	बंसरी
Baraa'a	बरा
Barkha	बरखा
Barsha	बर्षा
Baruni	बारुनी
Basabi	बसबी
Basanti	बसंती
Baseema	बसीमा
Basheera	बशीरा
Basma	बस्मा
Batool	बातूल
Bavishya	बविश्या
Beena	बीना
Bel	बेल
Bela	बेला
Belli	बेल्ली
Benazir	बेनजीर
Bethina	बेथिना
Bhadra	भद्रा
Bhadrusha	भाद्रुषा
Bhagavathi	भागावाथि
Bhagini	भगिनी
Bhagirathi	भागीरथी
Bhagwanti	भागवंती
Bhagwati	भगवती
Bhagyalakshmi	भाग्यलक्ष्मी
Bhagyashri	भाग्यश्री
Bhagyawati	भाग्यवती
Bhairavi	भैरवी
Bhakti	भक्ति
Bhama	भामा
Bhamini	भामिनी
Bhandhavi	भान्धवी
Bhanuja	भानुजा
Bhanumati	भानुमती
Bhanuni	भानुनी
Bhanupriya	भानुप्रिया
Bhanusri	भानुसरी
Bharati	भारती
Bharavi	भारवि
Bhargavi	भार्गवी
Bhaumi	भौमी
Bhavana	भावना
Bhavani	भवानी
Bhavi	भावी
Bhavika	भाविका
Bhavini	भाविनी
Bhavna	भावना
Bhavukta	भावुक्ता
Bhavya	भव्या
Bhawna	भावना
Bheema	भीमा
Bhooma	भूमा
Bhoomi	भूमि
Bhrithi	भ्रिथी
Bhumika	भूमिका
Bhupali	भूपाली
Bhuvana	भुवना
Bhuvi	भुवि
Bianca	बिंका
Bidisha	बिदिषा
Bijali	बिजली
Bijli	बिजली
Bimala	बिमला
Bimbi	बिम्बी
Bina	बिना
Bindhiya	बिन्धिया
Bindiya	बिंदिया
Bindu	बिन्दु
Binita	बिनीता
Bipasha	बिपाशा
Bishakha	बिशाखा
Bodhi	बोधि
Brijabala	ब्रिजबाला
Brinda	बृंदा
Briti	ब्रिती
Bulbul	बुलबुल
Bushra	बुशरा
Buthayna	बुथाय्ना
Chahel	चाहेल
Chain	चैन
Chaitan	चैतन
Chaitanya	चैतन्य
Chakor	चकोर
Chakradev	चक्रदेव
Chakradhar	चक्राधार
Chakrapani	चक्रपाणी
Chakravartee	चक्रवर्ती
Chakresh	चक्रेश
Chakshan	चक्षण
Chakshu	चक्षु
Chaman	चमन
Chamanlal	चमनलाल
Champak	चंपक
Chanak	चनक
Chanakya	चाणक्य
Chanchal	चंचल
Chanchareek	चंचारीक
Chandak	चंदक
Chandan	चंदन
Chandavarman	चंदावर्मन
Chander	चंदर
Chandidas	चंडीदास
Chandra	चंद्रा
Chandrabha	चंद्राभा
Chandrabhan	चन्द्रभान
Chandrachur	चंद्रचुर
Chandraditya	चंद्रादित्य
Chandragupt	चन्द्रगुप्त
Chandrahaas	चंद्रहास
Chandrahas	चन्द्रहास
Chandrak	चंद्रक
Chandrakanta	चंद्रकांता
Chandraketu	चन्द्रकेतु
Chandrakiran	चंद्रकिरण
Chandrakirthi	चंद्रकीर्ती
Chandrakishore	चंद्रकिशोर
Chandrakumar	चंद्रकुमार
Chandrama\dhav	चंद्रमाधाव
Chandramauli	चंद्रमौली
Chandramohan	चंद्रमोहन
Chandran	चंद्रन
Chandranan	चंद्रानन
Chandranath	चंद्रनाथ
Chandraprakash	चंद्रप्रकाश
Chandraraj	चंद्रराज
Chandrasen	चंद्रसेन
Chandrashekar	चंद्रशेकर
Chandrashekhar	चंद्रशेखर
Chandratha	चंद्रथा
Chandravadan	चन्द्रवदन
Chandrayan	चंद्रायण
Chandresh	चंद्रेश
Chandrodaya	चंद्रोदाया
Chandrpeed	चंद्र्पीद
Chane	चाने
Chanyana	चन्याना
Chapal	चपल
Charak	चरक
Charan	चरण
Charanjit	चरणजीत
Charanpal	चरणपाल
Charanpreet	चरणप्रीत
Charu	चारू
Charuchandra	चारुचंद्र
Charudatt	चारुदत्त
Charudatta	चारुदत्त
Charudutta	चारूदूत्ता
Charuhas	चारुहास
Charusheel	चरुशील
Charuvardhana	चारुवर्धना
Charuvindha	चारुविन्धा
Charuvrat	चरुव्रत
Chatresh	चत्रेश
Chatur	चतुर
Chaturanan	चतुरानन
Chaturbhuj	चतुरभुज
Cheliyan	चेलियाँ
Chellamani	चेल्लामनी
Chellamuthu	चेल्लामुथु
Chellapan	चेल्लापन
Chemmal	चेम्मल
Chetak	चेतक
Chetan	चेतन
Chetananand	चेतानानंद
Chevatkodiyon	चेवात्कोदियों
Chhandak	छंदक
Chhayank	छायांक
Chidakash	चिदाकाश
Chidambar	चिदंबर
Chidambaram	चिदंबरम
Chidananda	चिदानंदा
Chidatma	चिदात्मा
Chidhatma	चिधात्मा
Chiman	चिमन
Chinar	चिनार
Chinmay	चिन्मय
Chinmayananda	चिन्मयानंदा
Chinmayu	चिन्मयु
Chinnadurai	चिन्नादुराई
Chintak	चिंतक
Chintamani	चिंतमाणी
Chintan	चिंतन
Chintav	चिंतव
Chinthanaichelvan	चिंतनैचेलवान
Chintu	चिंटू
Chintya	चिंत्या
Chirag	चिराग़
Chiranjeev	चिरंजीव
Chirantan	चिरंतन
Chirayu	चिरायु
Chirtrang	चिर्त्रंग
Chitesh	चितेश
Chithayu	चितायु
Chitrabahu	चित्रबाहू
Chitrabhanu	चित्रभानु
Chitragupt	चित्रगुप्त
Chitragupta	चित्रगुप्त
Chitraketu	चित्रकेतु
Chitraksh	चित्रक्ष
Chitral	चित्रल
Chitrarath	चित्ररथ
Chitrasen	चित्रसेन
Chitresh	चित्रेश
Chitta	चित्ता
Chittaprasad	चित्तप्रसाद
Chittaranjan	चित्तरंजन
Chittaswarup	चित्तस्वरूप
Chittesh	चित्तेश
Cholan	चोलन
Chudamani	चूड़ामणि
Chunmay	चुन्मय
Chyavan	च्यवन
Crishdeep	क्रिश्दीप
Cauvery	कावेरी
Chaaya	छाया
Chadna	चदना
Chahana	चाहना
Chahna	चाहना
Chairavali	चैरावली
Chaitali	चैताली
Chaitaly	चैताली
Chaitanya	चैतन्य
Chaitra	चैत्रा
Chakori	चकोरी
Chakrika	चक्रिका
Chalama	चलामा
Chameli	चमेली
Champa	चंपा
Champabati	चंपाबती
Champakali	चंपाकली
Champakavathi	चम्पकावथी
Champakmala	चम्पक्माला
Champamalini	चंपामालिनी
Champika	चँपिका
Chanasya	चनास्या
Chanchala	चंचला
Chanchari	चंचारी
Chanda	चंदा
Chandalini	चंदालिनी
Chandana	चंदना
Chandani	चाँदनी
Chandanika	चान्दनिका
Chandi	चांदी
Chandika	चंदिका
Chandini	चान्दिनी
Chandni	चाँदनी
Chandrabali	चंद्राबली
Chandrabha	चंद्रभा
Chandrabhaga	चंद्रभागा
Chandrabindu	चंद्रबिंदु
Chandraja	चंद्रजा
Chandrajyoti	चन्द्रज्योति
Chandrakala	चंद्रकला
Chandrakali	चन्द्रकली
Chandrakanti	चंद्रकंती
Chandraki	चंद्रकी
Chandrakin	चंद्रकीन
Chandralekha	चंद्रलेखा
Chandraleksha	चंद्रलेक्षा
Chandramathi	चंद्रमति
Chandramukhi	चंद्रमुखी
Chandrani	चंद्रानी
Chandraprabha	चंद्रप्रभा
Chandrapushpa	चंद्रपुश्पा
Chandratara	चंद्रतारा
Chandravathi	चंद्रवाथि
Chandrika	चंद्रिका
Chandrima	चंद्रिमा
Chane	चने
Changuna	चंगुना
Chapala	चपला
Chara	चारा
Charita	चरिता
Charitra	चरित्रा
Charu	चारू
Charulata	चारुलता
Charulekha	चारुलेखा
Charumati	चारुमती
Charunetra	चारुनेत्र
Charuprabha	चारुप्रभा
Charusheela	चारुशीला
Charusila	चारुशीला
Charvi	चार्वी
Chatura	चतुरा
Chaunta	चौनता
Chayana	चायना
Chayla	चयला
Chellam	चेल्लाम
Chetana	चेतना
Chetna	चेतना
Chhabi	छ्बी
Chhavi	छवि
Chhavvi	छ्ववी
Chhaya	छाया
Chimayi	चिमायी
Chinmayi	चिन्मयी
Chintan	चिंतन चिनटनिका
Chintana	चिंतन चिनटनिका
Chintanika	चिंतानिका
Chiti	चिती
Chitkala	चित्कला
Chitra	चित्रा
Chitragandha	चित्रगंधा
Chitrakshi	चित्रक्षी
Chitralekha	चित्रलेखा
Chitrali	चित्राली
Chitramala	चित्रमाला
Chitramaya	चित्रमाया
Chitrangada	चित्रांगदा
Chitrani	चित्रानी
Chitrarathi	चित्ररथी
Chitrarekha	चित्ररेखा
Chitrathi	चित्रथी
Chitrita	चित्रिता
Chumban	चुंबन
Chunni	चुन्नी
Dabeet	दबीत
Daha	दहा
Dahana	दहन
Daitya	दैत्य
Daivya	दैव्या
Daiwik	दैविक
Daksh	दक्ष
Daksha	दक्षा
Dakshesh	दक्षेष
Dakshi	दक्षी
Dakshina	दक्षिणा
Dakshinayan	दक्शिनयन
Dalajit	दलजीत
Dalapathi	दलापथी
Dalbhya	दाल्भया
Dalbir	दलबीर
Daljeet	दलजीत
Dalpati	दलपति
Daman	दामन
Damian	डेमियन
Damodar	दामोदर
Dandak	दन्दक
Dandapani	दंदापानी
Danielle	दानिएल्ले
Danta	दंत
Danuj	दनूज़
Danvir	दानवीर
Darpad	दर्पद
Darpak	दर्पक
Darpan	दर्पण
Darsh	दर्श
Darshak	दर्शक
Darshan	दर्शन
Daruk	दारुक
Daruka	दारुका
Darun	दारुण
Dasharath	दशरथ
Dasharathi	दशरथी
Dasmaya	दस्माया
Datta	दत्ता
Dattatreya	दत्तात्रेया
Dattey	दत्तेय
Dawoud	दावौद
Dayada	दयादा
Dayakar	दयाकर
Dayakara	दयाकरा
Dayal	दयाल
Dayamay	दयामय
Dayanand	दयानंद
Dayanidhi	दयानिधि
Dayaram	दयाराम
Dayasagar	दयासागर
Dayasagara	दयासागर
Dayashankar	दयाशंकर
Dayaswarup	दयास्वरूप
Debashis	देबाशिस
Debashish	देबाशीष
Debjit	देब्जित
Deenabandhu	दीनबंधु
Deenanath	दीनानाथ
Deep	दीप
Deepak	दीपक
Deepan	दीपन
Deepankar	दीपनकर
Deependra	दीपेंद्र
Deependu	दीपेंदु
Deepesh	दीपेश
Deepinder	दीपिंदर
Deepit	दीपित
Deeptanshu	दीप्तान्शु
Deeptendu	दीप्तेंदु
Deeptiman	दीप्तिमान
Deeptimoy	दीप्तिमोय
Dehabhuj	देहाभुज
Denadayal	दीनदयाल
Dev	देव
Dev Kumar	देव कुमार
Devabrata	देवाब्रता
Devachandra	देवचंद्रा
Devadarshan	देवदर्शन
Devadas	देवदास
Devadatt	देवदत्त
Devadatta	देवदत्त
Devadeva	देवदेवा
Devadhipa	देवाधिपा
Devadutt	देवदूत्त
Devadyumna	देवाद्युमना
Devagya	देवाग्य
Devaj	देवाज
Devajuta	देवाजुता
Devajyoti	देवज्योति
Devak	देवक
Devakantha	देवाकांता
Devakinandan	देवकीनंदन
Devakumar	देवकुमार
Deval	देवल
Devamadana	देवमदाना
Devanand	देवानंद
Devang	देवांग
Devank	देवांक
Devansh	देवांश
Devapi	देवापी
Devaraj	देवराज
Devarpana	देवार्पना
Devarsi	देवर्सी
Devarya	देवार्या
Devashish	देवाशीष
Devbrata	देव्ब्रता
Devdarsh	देव्दर्ष
Devdas	देवदास
Devdatta	देवदत्त
Devdutta	देवदुत्ता
Devendar	देवेंदर
Devendra	देवेन्द्र
Devendranath	देवेन्द्रनाथ
Devesh	देवेश
Deveshwar	देवेश्वर
Devguru	देवगुरु
Devi	देवी
Devidas	देविदास
Devilal	देवीलाल
Deviprasad	देवीप्रसाद
Devjeet	देवजीत
Devkinandan	देवकीनंदन
Devkumar	देवकुमार
Devnarayan	देवनारायण
Devnath	देवनाथ
Devpad	देवपद
Devraj	देवराज
Devrat	देवरत
Devsena	देवसेना
Devvrata	देवव्रता
Devya	देव्या
Dhairya	धैर्य
Dhanajit	धनजीत
Dhananad	धनानाद
Dhananjay	धनंजय
Dhanapati	धनपति
Dhanesh	धनेश
Dhanraj	धनराज
Dhansukh	धनसुख
Dhanush	धनुष
Dhanvant	धनवंत
Dhanvantari	धन्वन्तरी
Dhanvin	धन्विन
Dhanvine	धन्विने
Dharamdeep	धरमदीप
Dharamdev	धरमदेव
Dharamjyot	धरमज्योत
Dharamnishth	धरमनिष्ठ
Dharampreet	धरमप्रीत
Dharamsheel	धरमशील
Dharanidhar	धरनीधर
Dharendra	धरेन्द्र
Dharitree	धारीत्री
Dharma	धर्मा
Dharmachandra	धर्मचंद्रा
Dharmadas	धर्मदास
Dharmadev	धर्मदेव
Dharmaditya	धर्मदित्य
Dharmaketu	धर्मकेतु
Dharmakirti	धर्मकीर्ति
Dharmanand	धर्मानंद
Dharmaraj	धर्मराज
Dharmaveer	धर्मवीर
Dharmender	धरमेंदर
Dharmendra	धर्मेन्द्र
Dharmendu	धर्मेंदु
Dharmesh	धर्मेश
Dharmik	धार्मिक
Dharm-mitra	धर्म-मित्र
Dharmpal	धरमपाल
Dharmpal	धरमपाल
Dharmveer	धर्मवीर
Dharuna	धरुना
Dhaval	धवल
Dhavalachandra	धवालाचंद्रा
Dhawal	धवल
Dheeman	धीमान
Dheemant	धीमंत
Dheer	धीर
Dheeran	धीरण
Dheerandra	धीरन्द्र
Dheerendra	धीरेन्द्र
Dheivamani	धेइवामानी
Dhevan	धेवन
Dhevaneyan	धेवानेयन
Dhikshit	धिक्षित
Dhilan	धिलन
Dhimant	धिमंत
Dhinakar	धिनकार
Dhinanta	धिनंता
Dhipin	धिपीन
Dhiraj	धीरज
Dhiren	धीरेन
Dhirendra	धीरेन्द्र
Dhritiman	ध्रितिमान
Dhrupad	ध्रुपद
Dhruv	ध्रुव
Dhul Fiqaar	धुल फिकार
Dhvanya	ध्वन्या
Dhwani	ध्वनि
Dhyana	ध्याना
Dhyanesh	ध्यानेश
Dhyaneshwar	ध्यानेश्वर
Digambar	दिगंबर
Digamber	दिगम्बर
Digant	दिगंत
Digvastra	दिग्वस्त्र
Digvijay	दिग्विजय
Dikshan	दीक्षण
Dilawar	दिलावर
Dilip	दिलीप
Dilnawaz	दिलनवाज़
Dinakar	दिनकर
Dinanath	दीनानाथ
Dinapati	दिनपति
Dinar	दिनार
Dindayal	दीनदयाल
Dinendra	दिनेंद्र
Dinesh	दिनेश
Dinkar	दिनकर
Dinpal	दिनपाल
Dipen	दिपेन
Dipendu	दिपेन्दु
Dipesh	दीपेश
Diptanshu	दिप्तान्शु
Divakar	दिवाकर
Divit	दिवित
Divyanga	दिव्यांगा
Divyanshu	दिव्यान्शु
Divyendu	दिव्यंदु
Divyesh	दिव्येश
Diya Udeen	दिया उदीन
Dron	द्रोण
Drupad	द्रुपद
Dulal	दुलाल
DuraiMurugan	दुरैमुरुगन
Duranjaya	दुरंज़ाया
Durgadas	दुर्गादास
Durgadutt	दुर्गादुत्त
Durgesh	दुर्गेश
Durijesh	दुरिजेश
Durja	दुर्जा
Durjaya	दुर्जय
Durmada	दुर्मदा
Durvish	दुर्विश
Dushyant	दुष्यंत
Dushyanta	दुश्यंता
Dvimidha	द्विमीधा
Dwaipayan	द्वैपायन
Dwaraka	द्वारका
Dwaraka-das	द्वारका-दास
Dwaraka-nath	द्वारका-नाथ
Dwijaraj	द्विजराज
Dwijendra	द्विजेंद्र
Dwijesh	द्वीजेश
Dyumani	दयुमानी
Dyumna	दयुम्ना
Dyutit	दयुतित
Dadhija	दधीजा
Daksha	दक्षा
Dakshakanya	दक्षकन्या
Dakshata	दक्षता
Dakshayani	दक्षयनी
Dakshina	दक्षिणा
Dalaja	दलज़ा
Damayanti	दमयंती
Damini	दामिनी
Damyanti	दमयंती
Darika	दारिका
Darpana	दर्पना
Darpanika	दर्पनिका
Darshana	दर्शना
Darshini	दर्शीनी
Daya	दया
Dayamayee	दयामयी
Dayamayi	दयामयी
Dayanita	दयानिता
Dayita	दयिता
Debanshi	देबन्शी
Deborah	देबोरह
Deeba	दीबा
Deeksha	दीक्षा
Deekshita	दीक्षिता
Deena	दीना
Deepa	दीपा
Deepabali	दीपाबली
Deepakala	दीपकला
Deepal	दीपल
Deepali	दीपाली
Deepamala	दीपमाला
Deepana	दीपाना
Deepanwita	दीपंविता
Deepaprabha	दीपप्रभा
Deepashikha	दीपशिखा
Deepavati	दीपावती
Deepika	दीपिका
Deepitha	दीपिथा
Deepshika	दीपशिका
Deepta	दीप्ता
Deepti	दीप्ति
Deeptikana	दीप्तिकाना
Deeptimoyee	दीप्तिमोयी
Deeta	दीता
Deetya	दीत्या
Deleena	देलीना
Delisha	देलिषा
Demira	देमिरा
Deshna	देशना
Desna	देसना
Devahuti	देवाहुती
Devak	देवक
Devakali	देवकली
Devakanya	देवकन्या
Devaki	देवकी
Devakiri	देवाकिरी
Devalatha	देवलथा
Devalekha	देवालेखा
Devamati	देवमति
Devamayi	देवमयी
Devangana	देवांगना
Devangi	देवांगी
Devani	देवानी
Devanshi	देवान्शी
Devapriya	देवाप्रिया
Devashree	देवाश्री
Devasmitha	देवास्मिथा
Devasree	देवश्री
Deveshi	देवेशी
Devi	देवी
Devika	देविका
Devina	देविना
Devishi	देविशी
Devkanya	देवकन्या
Devki	देवकी
Devmani	देवमणि
Devna	देवना
Devya	देव्या
Devyani	देव्यानी
Dhanalakshmi	धनलक्ष्मी
Dhanapriya	धनाप्रिया
Dhanashri	धनश्री
Dhanishta	धनिष्टा
Dhanvanti	धनवंती
Dhanvi	धन्वी
Dhanya	धन्या
Dhanyata	धन्यता
Dhara	धारा
Dharani	धरनी
Dharini	धारीनी
Dharitri	धारित्रि
Dharmista	धर्मिस्ता
Dharnitha	धरनिथा
Dharti	धरती
Dharuna	धरुना
Dhatri	धात्री
Dheeptha	धीप्त्हा
Dhitha	धिता
Dhithi	धिति
Dhlriti	ध्ल्रीती
Dhriti	धृति
Dhruti	धृति
Dhruva	ध्रुवा
Dhruvi	ध्रुवी
Dhruvika	ध्रुविका
Dhuha	धुहा
Dhuthi	धुथी
Dhuti	धुती
Digambari	दिगम्बरी
Diksha	दीक्षा
Dilber	दिल्बेर
Dilshad	दिल्शाद
Dipali	दिपाली
Dipashri	दिपाश्री
Dipti	दीप्ति
Disha	दिशा
Dishi	दिशी
Dishita	दिशिता
Diti	दिति
Divena	दीवेना
Divija	दिविजा
Divya	दिव्या
Divyana	दिव्यना
Divyanshi	दिव्यंशी
Diya	दिया
Doyel	दोयेल
Draupadi	द्रौपदी
Drisana	द्रिसना
Drishti	द्रिष्टी
Drishya	द्रिश्य
Dristi	द्रिसटी
Druthi	द्रुथी
Druti	द्रुती
Dulari	दुलारी
Durga	दुर्गा
Durva	दूर्वा
Dwipavati	द्विपावती
Dyumna	दयुम्ना
Dyuti	द्युती
Edhas	एधास
Edi	एदी
Ednit	एदनित
Eeshwar	ईश्वर
Egaiarasu	एगैअरासु
Eha	इहा
Ehimay	एहिमाय
Eka	एका
Ekachakra	एकाचक्र
Ekachandra	एकचंद्र
Ekachith	एकाचीत
Ekadant	एकदंत
Ekagrah	एकाग्रह
Ekaksh	एकाक्ष
Ekaksha	एकाक्षा
Ekakshara	एकाक्षर
Ekalavya	एकलव्या
Ekaling	एकलिंग
Ekalinga	एकलिन्गा
Ekambar	एकाम्बर
Ekana	एकना
Ekanath	एकनाथ
Ekanga	एकांगा
Ekani	एकानी
Ekanjeet	एकानजीत
Ekanpreet	एकानप्रीत
Ekansh	एकांश
Ekant	एकांत
Ekapad	एकपद
Ekaraj	एकराज
Ekatan	एकतन
Ekatma	एकात्मा
Ekavir	एकाविर
Ekavira	एकाविरा
Ekayavan	एकयावन
Ekbal	इकबाल
Eklavya	एकलव्य
Eknath	एकनाथ
Ekodar	एकोदर
Ekram	एक्रम
Elango	एलांगो
Elil	ईलिल
Elilarasan	एलीलरासन
Elilarasu	एलीलरासू
Elilvendan	एलीलवेंदन
Ellu	एल्लू
Elumalai	एलुमलाई
Esh	एश
Eshan	एषां
Eshwar	एश्वर
Eshwardutt	ईश्वरदत्त
Etash	एताश
Ettan	एत्तन
Evyavan	एव्यावन
Easmatara	एअस्मतारा
Ecchumati	एच्चुमति
Edha	एधा
Edhitha	एधीथा
Eesha	ईशा
Ehimaya	एहिमाया
Eila	एइला
Eiravati	एईरावती
Eka	एका
Ekaa	एका
Ekadhana	एकाधना
Ekaja	एकज़ा
Ekani	एकानी
Ekanta	एकान्त
Ekantha	एकांता
Ekanthika	एकांतिका
Ekantika	एकान्तिका
Ekaparana	एकपराना
Ekaparnika	एकापर्निका
Ekavali	एकावली
Ekisha	एकिशा
Ekta	एकता
Ela	एला
Elampirai	इलामपिराई
Elavarasi	एलावारसी
Elili	एलीली
Elina	एलीना
Enakshi	एनक्षी
Ereshva	एरेश्व
Esha	एशा
Eshana	एशाना
Eshanika	एशानिका
Eshanya	एशान्य
Eshika	एशिका
Eshita	एशीता
Esita	एसिता
Eta	एता
Fadi	फ़दी
Fadl	फ़द्ल
Fadl Ullah	फ़द्ल उल्लाह
Fahad	फहद
Faisal	फ़ैसल
Faiyaz	फ़ैयाज़
Faiz	फ़ैज़
Faizan	फैजान
Faizeen	फैजीन
Fakhir	फाखिर
Fakhry	फख्री
Falak	फलक
Falgu	फ़ाल्गु
Fanibhusan	फ़निभूसन
Fanindra	फनिंद्र
Fanish	फणीश
Fanishwar	फनिश्वर
Faraz	फ़राज़
Fareed	फरीद
Farhad	फ़रहाद
Farhan	फरहान
Farhat	फ़रत
Farid	फ़रीद
Faris	फ़ारिस
Farooq	फ़ारूक़
Farukh	फ़ारूख़
Fateen	फतीन
Fateh	फ़तेह
Fatik	फतिक
Fawaz	फ़वाज़
Fayaz	फ़याज़
Fidaa	फ़िदा
Firaas	फिरास
Firdaus	फिरदौस
Firoz	फ़िरोज़
Fravash	फ्रवश
Fuad	फ़ुआद
Faatin	फातिन
Faatina	फातिना
Fadheela	फाधीला
Fadhiya	फाधिया
Fadwa	फदवा
Fahamitha	फहमिथा
Faiza	फ़ैज़ा
Fajyaz	फाज्याज़
Falguni	फ़ाल्गुनी
Fareeda	फरीदा
Fareeha	फरीहा
Farha	फरहा
Farhina	फरहिना
Faria	फ़ारिया
Farida	फ़रीदा
Fatima	फातिमा
Fawiza	फावीज़ा
Fawziya	फव्जिया
Fazeela	फजीला
Firaki	फिरकी
Firdoos	फिर्दूस
Firoza	फ़िरोज़ा
Firyal	फिर्याल
Fizza	फिज्ज़ा
Fizzah	फिज्जाह
Foolan	फूलन
Foolwati	फूलवती
Foram	फॉरम
Forum	फॉरम
Fulki	फुलकी
Fullan	फुल्लन
Fullara	फुल्लारा
Fulmala	फूलमाला
Gadhadhar	गधाधर
Gadin	गदीन
Gagan	गगन
Gagandeep	गगनदीप
Gaganjyot	गगनज्योत
Gaganvihari	गगन विहारी
Gagnesh	गग्नेश
Gajadhar	गजाधर
Gajanan	गजानन
Gajanand	गजानंद
Gajbahu	गजबाहू
Gajdant	गजदंत
Gajendra	गजेन्द्र
Gajendranath	गजेंद्रनाथ
Gajinder	गजिंदर
Gajkaran	गज्करण
Gajpati	गजपति
Gajrup	गजरूप
Gajvadan	गजवदन
Gambhir	गंभीर
Ganak	गणक
Ganaka	गानका
Ganapati	गणपति
Ganaraj	गणराज़
Gandesha	गंदेशा
Gandha	गंधा
Gandhar	गंधार
Gandharaj	गंधरज
Gandharv	गन्धर्व
Gandharva	गान्धर्व
Gandhik	गांधिक
Gandira	गंदिरा
Gandiva	गंदिवा
Ganendra	गनेंद्र
Ganesh	गणेश
Gangadatt	गंगदत्त
Gangadhar	गंगाधार
Gangadutt	गंगादुत्त
Gangesh	गंगेश
Gangesha	गंगेशा
Gangeya	गंगेया
Gangol	गंगोल
Ganjan	गंजन
Gannath	गणनाथ
Gannon	गन्नों
Garg	गर्ग
Garisht	गरिष्ट
Garjan	गर्जन
Garud	गरुड़
Gatik	गतिक
Gaurang	गौरांग
Gaurav	गौरव
Gauresh	गौरेश
Gaurikant	गौरिकांत
Gaurinandan	गौरिनंदन
Gaurinath	ग़ौरिनाथ
Gaurish	गौरीश
Gaurishankar	गौरीशंकर
Gaurisuta	गौरिसुता
Gautam	गौतम
Gaveshan	गवेषण
Gavisht	गविष्ट
Gayak	गायक
Gayan	गायन
Geet	गीत
Ghalib	घालिब
Ghalib	घालिब
Ghananand	घनानंद
Ghanashyam	घनश्याम
Ghanendra	घनेंद्र
Ghanshyam	घनश्याम
Ghasaan	घसान
Ghazi	घाज़ी
Ghiyaath	घियाथ
Girdhari	गिरधारी
Giri	गिरी
Giridari	गिरिदारी
Giridhar	गिरिधर
Girijanandan	गिरिजानंदन
Girik	गिरिक
Girilal	गिरिलाल
Girindra	गिरीन्द्र
Giriraj	गिरिराज
Girish	गिरीश
Girivar	गिरिवर
Girvan	गिर्वान
Gitashri	गिताश्री
Gobhil	गोभिल
Gogula	गोगुला
Gokul	गोकुल
Gopal	गोपाल
Gopan	गोपान
Gopesh	गोपेश
Gopi	गोपी
Gopichand	गोपीचंद
Gorakh	गोरख़
Gorakh-nath	गोरख-नाथ
Goral	गोरल
Goswamee	गोस्वामी
Gourishankar	गौरीशंकर
Govardhan	गोवर्धन
Govind	गोविंद
Govinda	गोविंदा
Grahish	ग्राहिश
Granthik	ग्रंथिक
Grihith	गृहित
Grishm	ग्रीष्म
Gudakesha	गुदाकेशा
Gul	गुल
Gulab	गुलाब
Gulal	गुलाल
Gulfam	गुलफाम
Gulshan	गुलशन
Gulzar	गुलज़ार
Gulzarilal	गुलजारीलाल
Guna	गुना
Gunagya	गुनाग्य
Gunaja	गुनाजा
Gunakar	गुनाकर
Gunalan	गुनालन
Gunamay	गुनामय
Gunaratna	गुनारत्ना
Gunayukth	गुनायूक्त
Gunin	गुनीन
Gunina	गुनिना
Gunjan	गुंजन
Gunvant	गुनवंत
Gunwant	गुनवंत
Gupil	गुपिल
Gurbachan	ग़ुरबचन
Gurcharan	गुरचरण
Gurdayal	गुरदयाल
Gurdeep	गुरदीप
Gurdweep	गुरद्वीप
Gurjas	गुरजास
Gurman	गुरमान
Gurmeet	गुर्मीत
Gurmukh	गुरमुख
Gurnam	गुरनाम
Gurnam	गुरनाम
Gurpreet	गुरप्रीत
Gursharan	गुरशरण
Guru	गुरु
Gurubachan	गुरुबचन
Gurucharan	गुरुचरण
Gurudas	गुरुदास
Gurudatt	गुरुदत्त
Gurudeep	गुरुदीप
Gurudutt	गुरुदूत्त
Gurusharan	गुरुशरण
Guruttam	गुरुत्तम
Gurveer	गुरवीर
Gurvinder	गुरविंदर
Gyan	ज्ञान
Gyandev	ज्ञानदेव
Gagana	गगना
Gaganadipika	गगनदीपिका
Gaganasindhu	गगनासिंधू
Gajagamini	गजगामिनी
Gajalakshmi	गजलक्ष्मी
Gajra	गजरा
Ganda	गंदा
Gandha	गंधा
Gandhali	गंधाली
Gandhara	गंधारा
Gandhari	गांधारी
Gandharika	गान्धरिका
Gandhini	गांधिनी
Ganesa	गनेसा
Ganga	गंगा
Gangi	गंगी
Gangika	गंगिका
Gangotri	गंगा
Ganika	गनिका
Ganitha	गणिता
Garati	गरती
Gargi	गार्गी
Garima	गरिमा
Gathika	गाथिका
Gatita	गतिता
Gauhar	गौहर
Gaura	गौरा
Gauri	ग़ौरी
Gaurika	ग़ौरिका
Gautami	गौतमी
Gayana	गायना
Gayanthika	गायंतिका
Gayatri	गायत्री
Gazala	गजाला
Geena	गीना
Geeta	गीता
Geeti	गीति
Geetika	गीतिका
Geshna	गेशना
Ghaada	घादा
Ghaaliya	घालिया
Ghaydaa	घाय्दा
Ghusoon	घुसून
Gina	गिना
Ginni	गिन्नी
Gira	गिरा
Giribala	गिरिबाला
Girija	गिरिजा
Girika	गिरिका
Girisha	गीरिषा
Gita	गीता
Gitali	गिताली
Gitanjali	गीतांजलि
Gitashri	गिताश्री
Gitika	गितिका
Giva	गिवा
Goda	गोदा
Godavari	गोदावरी
Godavri	गोदावरी
Gomati	गोमती
Gomti	गोमती
Gool	गूल
Gopa	गोपा
Gopi	गोपी
Gopika	गोपी
Gorma	गोरमा
Gorochana	गोरॉचना
Gourangi	गौरांगी
Govindi	गोविन्दी
Gowri	गोवरी
Greeshma	ग्रीष्मा
Grhalakshmi	ग्रहलक्ष्मी
Grhitha	ग्रहीता
Grishma	ग्रिष्मा
Guddu	गुडडू
Gudiya	गुड़िया
Gul	गुल
Gulab	गुलाब
Gulika	गुलिका
Gunasundari	ग़ुनसूंदरी
Gunavati	गुनावती
Gunita	गुनिता
Gunitha	गुणिथा
Gunjana	गूंजना
Gunjika	गूंजीका
Gunjita	गूंजीता
Gunnika	गुन्नीका
Gunwanti	गुनवंती
Gurinder	गुरिंदर
Gurjari	गुर्जरी
Gurneet	गुरनीत
Gurpreet	गुरप्रीत
Gyanada	ज्ञानादा
Haady	हादी
Haamid	हामिद
Haani	हानि
Habib	हबीब
Hafiz	हाफ़िज़
Hakesh	हाकेश
Hamid	हामिद
Hamir	हमीर
Hammad	हम्माद
Hamshad	हम्शाद
Hamza	हम्ज़ा
Hans	हँस
Hansaraj	हंसराज
Hanshal	हंशल
Hansin	हंसिन
Hansraj	हंसराज
Hanuman	हनुमान
Hanumant	हनुमंत
Har	हर
Hara	हरा
Harbhajan	हरभजन
Harbinder	हरबिंदर
Harbir	हरबिर
Hardeep	हरदीप
Hardik	हार्दिक
Hareendra	हरीन्द्र
Harekrishna	हरेकृष्ण
Harendra	हरेन्द्र
Haresh	हरेश
Hari	हरी
Hariaksa	हरिअक्सा
Haricharan	हरिचरण
Haridas	हरिदास
Harigopal	हरिगोपाल
Harihar	हरिहर
Harij	हरिज
Harikanth	हरिकांत
Harikrishna	हरिकृष्ण
Harilal	हरिलाल
Harinaksh	हरिनक्ष
Harinarayan	हरिनारायण
Harinder	हरिंदर
Harindra	हरिन्द्र
Harindranath	हरिन्द्रनाथ
Hariom	हरिओम
Hariprasad	हरिप्रसाद
Haripreet	हरिप्रीत
Hariraj	हरीराज
Hariram	हरीराम
Harish	हरीश
Harishankar	हरिशंकर
Harishchandra	हरिश्चंद्र
Harit	हारित
Haritbaran	हरितबारण
Harith	हरित
Harith	हारिथ
Harivansh	हरिवंश
Harivilas	हरिविलास
Harjeet	हरजीत
Harjeet	हरजीत
Harjyot	हरज्योत
Harkrishna	हरकृष्ण
Harman	हरमान
Harmeet	हरमीत
Harmendra	हर्मेंद्र
Haroon	हारून
Haroon	हारून
Harpal	हरपाल
Harpreet	हरप्रीत
Harsh	हर्ष
Harsha	हर्शा
Harshad	हर्शद
Harshal	हर्शल
Harshaman	हर्षमन
Harshavardhan	हर्षवर्धन
Harshil	हर्शिल
Harshit	हर्षित
Harshul	हर्शूल
Harshvardhan	हर्षवर्धन
Harteij	हर्तेइज
Hasan	हसन
Hashim	हाशिम
Hashmat	हशमत
Hasit	हसीत
Hasmukh	हसमुख
Hassan	हास्सन
Hastin	हस्तिन
Hatim	हातिम
Havish	हविष
Haytham	हयथम
Hazrat	हजरत
Heer	हीर
Hem	हेम
Hemachandra	हेमचंद्रा
Hemadri	हेमाद्री
Hemakesh	हेमाकेश
Hemal	हेमल
Hemamdar	हेमंदर
Heman	हेमन
Hemang	हेमांग
Hemanga	हेमांगा
Hemant	हेमंत
Hemaprakash	हेमाप्रकाश
Hemaprasad	हेमाप्रसाद
Hemaraj	हेमराज
Hemavatinandan	हेमावातिनंदन
Hemchander	हेमचंदर
Hemdev	हेमदेव
Hemen	हेमन
Hemendra	हेमेंद्र
Hemendu	हेमेंदु
Hemish	हेमिश
Hemraj	हेमराज
Heramba	हेरंबा
Himachal	हिमाचल
Himadri	हिमाद्री
Himaghna	हिमाघ्ना
Himanish	हिमानिश
Himank	हिमांक
Himanshu	हिमांशु
Himmat	हिम्मत
Himnish	हिमनिश
Hiranmay	हिरंमय
Hiranmaya	हिरंमाया
Hiranya	हिरन्य
Hiranyak	हिरंयक
Hiren	हिरेन
Hirendra	हिरेन्द्र
Hiresh	हिरेश
Hiten	हितेन
Hitendra	हितेन्द्र
Hitesh	हितेश
Houd	हौद
Hriday	हृदय
Hridayanand	हृदयानंद
Hridayanath	हृदयनाथ
Hridayesh	हृदयेश
Hridaynath	हृदयनाथ
Hridik	हृदिक
Hridyanshu	हृद्यांशु
Hriman	हरिमन
Hrishi	ह्रिशी
Hrishikesh	हृषिकेश
Hrithik	ह्रिथिक
Hritish	हृतिश
Humam	हुमाम
Hurditya	हुर्दित्या
Husaam	हुसाम
Hussain	हूसेन
Hussein	हुसैन
Huthayfa	हुथाय्फा
Haadiya	हादिया
Haala	हाला
Habiba	हबीबा
Hadiya	हदिया
Hafiza	हाफ़िज़ा
Haifa	हैफा
Haimavati	हैमवती
Haimi	हैमी
Haleema	हलीमा
Hameeda	हमीदा
Hamsa	हँसा
Hamsini	हम्सिनी
Hana	हना
Hanan	हनान
Haneefa	हनीफा
Hanima	हनीमा
Haniya	हनिया
Hansa	हँसा
Hansamala	हंसमाला
Hansanandini	हन्सनंदिनी
Hansaveni	हंसवेनी
Hansika	हनसीका
Hansini	हंसीनी
Hardipa	हरदिपा
Haribala	हरिबाला
Hariganga	हरिगंगा
Harijatha	हरिजाथा
Harimanti	हरिमंती
Harinakshi	हरिनाक्षी
Harini	हरीनी
Haripriya	हरीप्रिया
Harita	हरिता
Harithi	हरिति
Harmya	हरम्या
Harsha	हर्षा
Harshada	हर्षदा
Harshi	हरषी
Harshini	हर्षीनी
Harshita	हर्षिता
Harshitha	हर्शिथा
Harsika	हर्सिका
Hasanthi	हासंथी
Hasika	हासिका
Hasina	हसीना
Hasita	हसीता
Hasna	हसना
Hasumati	हसूमति
Hatisha	हतिशा
Haya	हया
Hayaam	हयाम
Hayat	हयात
Heena	हर्न्ना
Heerkani	हीरकनी
Hema	हेमा
Hemakshi	हेमाक्षी
Hemal	हेमल
Hemalata	हेमलता
Hemangi	हेमाँगी
Hemangini	हेमांगीनी
Hemani	हेमानी
Hemanti	हेमांति
Hemanya	हेमान्या
Hemaprabha	हेमप्रभा
Hemashri	हेमाश्री
Hemavati	हेमावती
Hemkanta	हेमकांता
Hemlata	हेमलता
Hena	हेना
Henna	हेन्ना
Hera	हेरा
Hessa	हेस्सा
Hetal	हेतल
Hilla	हिल्ला
Hima	हिमा
Himagouri	हिमागौरी
Himaja	हिमाजा
Himani	हिमानी
Hina	हिना
Hind	हिंद
Hinda	हिन्दा
Hindola	हिंदोला
Hira	हीरा
Hiral	हिरल
Hiranmayi	हिरंमयी
Hiranya	हिरन्य
Hiranyadha	हिरन्यधा
Hirkani	हिरकनी
Hita	हीता
Hitaishi	हितैषी
Hiya	हिया
Hiza	हिज़ा
Holika	होलिका
Hoor	हूर
Hooriya	हूरिया
Hradha	ह्राधा
Hradini	ह्रादिनी
Hridya	हृदय
Huda	हुदा
Huma	हुमा
Humaila	हुमैला
Husn	हुस्न
Husna	हुसना
Hyma	ह्य्मा
Ibhanan	ईभानन
Ibhya	इभ्या
Ibraheem	इब्राहीम
Ibrahim	इब्राहिम
Ichaa	इछा
Idaspati	इदस्पति
Idhant	इधांत
Idrees	इदरीस
Idris	इद्रिस
Iesa	इएसा
Iham	ईहम
Ihit	इहीत
Ihsaan	इह्सान
Ihtesham	इहतेषम
Ijay	इजय
Ikram	इक्रम
Ikrimah	इक्रीमः
Ikshan	इक्षण
Ikshu	इक्शु
Ilaiyavan	इलैयावन
Ilamporai	इलाम्पोरई
Ilamurugu	इलामुरुगु
Ilancheliyan	इलान्चेलियाँ
Ilandevan	इलान्देवन
Ilango	इलांगो
Ilanthirayan	इलान्थिरायण
Ilashpasti	इलाश्पस्ती
Ilavalagan	इलावलगन
Ilavarasan	इलवरसन
Ilavenil	इलवेनिल
Ilesh	इलेश
Ilisa	इलिसा
Illiyas	इल्लियास
Ilyas	इल्यास
Imaad	इमाद
Imaad Udeen	इमाद उदीन
Iman	ईमान
Imaran	इमरान
Imraan	इमरान
Imran	इमरान
Imtiaz	इम्तिआज़
Imtiyaz	इम्तियाज़
Inakanta	इनकांता
Inas	इनास
Inbanathan	इंबनाथन
Indeever	इंदीवर
Inderbir	इंदरबीर
Inderjeet	इंदरजीत
Inderpreet	इंदरप्रीत
Inderveer	इंदरवीर
Indivar	इंदिवर
Indra	इंद्रा
Indradatt	इन्द्रदत्त
Indradutt	इन्द्रदुत्त
Indradyumn	इन्द्रदयुम्न
Indrajeet	इन्द्रजीत
Indrajit	इन्द्रजित
Indrakanta	इन्द्रकांता
Indraneel	इंद्रनील
Indrarjun	इन्द्रार्जुन
Indrasen	इन्द्रसेन
Indrasena	इन्द्रसेना
Indrasuta	इन्द्रसुता
Indratan	इन्द्रतन
Indravadan	इन्द्रवदन
Indubhushan	इंदुभूषण
Induhasan	इन्दुहासन
Induj	इन्दुज
Indukant	इन्दुकांत
Indukanta	इन्दुकांता
Indulal	इंदुलाल
Indumal	इन्दुमल
Indumat	इन्दुमत
Indumauli	इन्दुमौली
Indushekhar	इंदुशेखर
Inesh	इनेश
Inganam	इन्गनाम
Iniyavan	ईनियवन
Inoday	इनोदय
Inshaf	इन्शाफ़
Intekhab	इन्तेखाब
Ipsit	इप्सित
Iqbal	इक़बाल
Iraiyavan	इरैयावन
Iraj	इराज
Iravan	इरावन
Iravat	इरावत
Iresh	इरेश
Irfaan	इरफान
Irfan	इरफ़ान
Iri	इरी
Irshaad	इरशाद
Irya	इर्या
Isaam	इसाम
Isaiarasu	इसैअरासु
Isaivalan	ईसैवलन
Isar	इसार
Ish	इश
Is-haaq	इस-हाक
Ishan	ईशान
Ishat	इशत
Ishayu	इशायु
Ishir	इशिर
Ishit	इषित
Ishrat	इशरत
Ishwar	ईश्वर
Ismaael	इस्माएल
Itish	इतीश
Iyad	इयाद
Iyyappan	इय्याप्पन
Izhar	इज़हार
Izz Udeen	इज उदीन
Ibha	ईभा
Ibtihaaj	इब्तिहाज
Idha	इधा
Idhika	इधिका
Idhitri	इधित्री
Idika	इदिका
Iditri	इदित्री
Iha	ईहा
Ihina	इहिना
Ihita	इहिता
Ihitha	इहिता
Ijaya	इजया
Ikraam	इकराम
Iksha	इक्शा
Ikshana	इक्शाना
Ikshita	इक्षिता
Ikshitha	इक्षिथा
Ikshu	इक्शु
Ikshula	इक्शुला
Iksura	इक्सुरा
Ila	इला
Ilampirai	इलंपीरई
Ilavalagi	इलावालागी
Ilavenil	इलावेनिल
Ilhaam	इलहाम
Ilisha	इलिशा
Imani	इमानी
Imtithal	इम्तिथल
Ina	ईना
Inaam	इनाम
Inas	इनास
Inaya	इनाया
Inayat	इनायत
Indali	इन्दाली
Indira	इंदिरा
Indiya	इंडिया
Indrakshi	इन्द्राक्षी
Indrani	इन्द्राणी
Indrasena	इन्द्रसेना
Indratha	इंद्रता
Indrayani	इंद्रयानी
Indrina	इन्द्रिना
Indu	इंदु
Induja	इंदुजा
Indukala	इंदुकला
Indulala	इंदुलाला
Indulekha	इन्दुलेखा
Induleksh	इंदुलेक्ष
Induma	इंदूमा
Indumati	इंदुमती
Indumauli	इन्दुमौली
Indumukhi	इंदुमुखी
Induprabha	इन्दुप्रभा
Inika	ईनीका
Iniya	ईनिया
Inkurali	इन्कुराली
Intisaar	इन्तिसार
Inu	इनु
Ipsa	इप्सा
Ipsita	इप्सिता
Ira	इरा
Iraja	इराजा
Iravati	इरावती
Irit	इरित
Isai	ईसाई
Isha	ईशा
Ishana	इशाना
Ishani	ईशानी
Ishanika	इशानिका
Ishanvi	इशान्वी
Ishanya	इशान्य
Ishi	इशी
Ishika	इशिका
Ishita	इशिता
Ishrat	इशरत
Ishta	इष्टा
Ishwari	ईश्वरी
Ishwarya	इश्वार्य
Ishya	इष्य
Itkila	इत्किला
Ivy	इव्य
Iyalisai	इयलीसाई
Iyla	इयला
Izdihaar	इज्दिहार
Jaabir	जाबिर
Jaafar	जाफर
Jabez	जाबेज़
Jadhav	जाधव
Jag	जाग
Jag Jivan	जग जीवन
Jagachandra	जागचंद्रा
Jagad	जगड़
Jagadayu	जगदायु
Jagadbandu	जगदबंदु
Jagadeep	जगदीप
Jagadev	जगदेव
Jagadhidh	ज़गधीध
Jagadhish	जगधिश
Jagadip	जगदीप
Jagadish	जगदीश
Jagajeet	जगजीत
Jagajeevan	जगजीवन
Jagan	जगन
Jaganmay	जगंमय
Jagannath	जगन्नाथ
Jagat	जगत
Jagatbehari	जगतबहरी
Jagatguru	जगतगुरु
Jagath	जगत
Jagatkishor	जगतकिशोर
Jagatpal	जगतपाल
Jagatprabhu	जगतप्रभु
Jagatprakash	जगतप्रकाश
Jagatveer	जगतवीर
Jagdeep	जगदीप
Jagdeo	जग्देओ
Jagdish	जगदीश
Jagesh	जागेश
Jagger	जग्गेर
Jagish	जगिश
Jagjeevan	जगजीवन
Jagmohan	जगमोहन
Jagrav	जग्रव
Jagreet	जागरीत
Jahan	जहान
Jahi	जाही
Jahnu	जाहनु
Jai	जय
Jaichand	जैचंद
Jaidayal	जय दयाल
Jaideep	जयदीप
Jaidev	जैदेव
Jaigath	जगत
Jaigopal	जय गोपाल
Jaikrishna	जय कृष्ण
Jaimini	जैमिनी
Jainarayan	जय नारायण
Jainil	जैनिल
Jaipal	जयपाल
Jairaj	जैराज
Jairam	जैराम
Jaisal	जैसल
Jaishankar	जय शंकर
Jaisukh	जयसुख
Jaithra	जैथरा
Jaitra	जैत्र
Jaival	जैवल
Jaivant	जयवंत
Jaivardhan	जयवर्धन
Jaiveer	जयवीर
Jaiwant	जैवंत
Jakarious	जकरिऔस्
Jalaal	जलाल
Jalad	जलद
Jalal	जलाल
Jalbhushan	जलभुशन
Jaldev	जलदेव
Jaldhar	जलधर
Jalender	जलेन्दर
Jalendra	जालेंद्र
Jalendu	जालेंदु
Jalesh	जलेश
Jalil	जलील
Jalindra	ज़ालिनद्रा
Jalindra	जलिन्द्र
Jalsa	जलसा
Jamaal	जमाल
Jamaal Udeen	जमाल उदीन
Jamal	जमाल
Jameel	जामील
Janak	जनक
Janakibhushan	जानकीभूषण
Janakidas	जानकीदास
Janakinath	जानकीनाथ
Janakiraman	जानकीरमन
Janamejay	जानामेज़य
Janardan	जनार्दन
Janav	जनाव
Janesh	जनेश
Janith	जनिथ
Jankesh	जन्केश
Janmesh	जन्मेश
Janu	जानु
Janya	जन्य
Japa	जपा
Japan	जपन
Japendra	जपेंद्र
Japesh	जपेश
Jarrar	जर्रार
Jasamit	जसमित
Jasapal	जसपाल
Jasbeer	जसबीर
Jashan	जशन
Jashith	जशिथ
Jashun	जशुन
Jasjit	जसजीत
Jaskaran	जस्करण
Jaspal	जसपाल
Jasraj	जसराज
Jasveer	जसवीर
Jasvinder	जसविंदर
Jaswant	जसवंत
Jaswant	जसवंत
Jatan	जतन
Jatasya	जतास्या
Jatayu	जटायु
Jatin	जतिन
Jatinder	जतिन्दर
Jatya	जत्या
Javed	जावेद
Javesh	जवेश
Javin	जाविन
Jawad	जवाद
Jawahar	जवाहर
Jay	जय
Jayachand	जयचंद
Jayad	जायद
Jayadeep	जयदीप
Jayaditya	जयदित्या
Jayakrishan	जयाक्रिशन
Jayant	जयंत
Jayanta	जयंता
Jayapal	जयपाल
Jayaprakash	जयप्रकाश
Jayashekhar	जयशेखर
Jayawant	जयवंत
Jayendra	जयेन्द्र
Jayesh	जयेश
Jayin	जयीन
Jaysukh	जयसुख
Jeemutbahan	जीमुत्बाहन
Jeevan	जीवन
Jeevanprakash	जीवंप्रकाश
Jeevaraj	जीवराज
Jehangir	ज़ेहांगीर
Jenya	जेन्या
Jhoomer	झूमेर
Jhulier	झुलिएर
Jhumar	झूमर
Jigar	जिगर
Jiger	जिगेर
Jignesh	जिज्ञेश
Jihad	जिहाद
Jihan	जिहान
Jilesh	जिलेश
Jimuta	जिमुता
Jina	जीना
Jinabhadra	जिनाभद्र
Jinadev	जिनादेव
Jinendra	जिनेन्द्र
Jishnu	जिश्नु
Jitamitra	जितामित्र
Jitender	जीतेन्दर
Jitendra	जीतेन्द्र
Jivaj	जिवज
Jival	जीवल
Jivana	जीवना
Jivesh	जीवेश
Jivin	जीविन
Jivitesh	जीवितेश
Jivraj	जीवराज
Jnhih	ज्न्हिः
Jnyandeep	ज्ञानदीप
Jnyaneshwar	ज्ञानेश्वर
Jogesh	जोगेश
Joginder	जोगिन्दर
Joginder	जोगिंद्रा
Jogindra	जोगिंद्रा
Jograj	जोगराज
Jugal	जुगल
Jugnu	जुगनू
Jujhar	जुज़ार
Jusal	जुसल
Jwala	ज्वाला
Jwalant	ज्वलंत
Jwalaprasad	ज्वालाप्रसाद
Jwalia	ज्वालिया
Jyestha	जयेस्था
Jyotichandra	ज्योतिचंद्र
Jyotindra	ज्योतिन्द्र
Jyotiprakash	ज्योतीप्राकाश
Jyotiranjan	ज्योतिरंजन
Jyotirdhar	ज्योतिर्धर
Jyotirmaya	ज्योतिर्मय
Jyotirmoy	ज्योतिरमोय
Jaba	जबा
Jabeen	जबीन
Jagadamba	जगदम्बा
Jagadambika	जगदम्बिका
Jaganmata	जगनमाता
Jaganmayee	जगनमई
Jaganmohini	जगनमोहिनी
Jagathi	जागती
Jagati	जगती
Jagavi	जागवी
Jagrati	जाग्रति
Jagriti	जागृति
Jagruti	जागृति
Jagvi	जग्वी
Jahanara	जहाँआरा
Jaheel	जहील
Jahnavi	जाह्नवी
Jailekha	ज़ैलेखा
Jaiman	जैीमन
Jaimathi	जैमाथि
Jaina	जैना
Jaipriya	जैप्रिया
Jaishree	जयश्री
Jaisudha	जैसुधा
Jaitashri	जैताश्री
Jaiwanti	जैवंती
Jala	जला
Jalabala	ज़लाबला
Jaladhi	जलधि
Jaladhija	जलधीजा
Jalahasini	जलहसिनी
Jalaja	जलज़ा
Jalanhili	जलंहिली
Jalbala	जलबाला
Jalela	जालेला
Jalpa	जल्पा
Jalsa	जलसा
Jameela	जमीला
Jameerah	जमीराह
Jamini	ज़मीनी
Jamuna	जमुना
Janaan	जनान
Janaki	जानकी
Janaknandini	जनकनंदिनी
Janani	जाननी
Janavika	जनाविका
Janhavi	जान्हवी
Janhitha	जानहिता
Janisha	जनिषा
Janitha	जनिता
Janki	जानकी
Jansi	जांसी
Januja	जनूज़ा
Janya	जन्य
Jarul	जरुल
Jasmin	जस्मिन
Jasminder	जसमिंदर
Jasmit	जस्मित
Jasoda	जसोदा
Jasodhara	ज़सोधरा
Jaspinder	जसपिंदर
Jasu	जसु
Jasum	जसुम
Jasweer	जसवीर
Javeria	जवेरिया
Jaya	जया
Jayalakshmi	जयालक्ष्मी
Jayalalita	जयललिता
Jayamala	जयमाला
Jayan	जयन
Jayani	जयानी
Jayanti	जयंती
Jayantika	जयंतिका
Jayaprabha	जयप्रभा
Jayaprada	जयाप्रदा
Jayashree	जयश्री
Jayashri	जयश्री
Jayasudha	जयसुधा
Jayati	जयति
Jayavanti	जयवंती
Jayita	जयिता
Jayitri	जायित्री
Jayna	जयना
Jayne	जयने
Jayshri	जयश्री
Jeeteshi	जीतेशी
Jeeval	जीवल
Jeevankala	जीवनकला
Jeevanlata	जीवनलता
Jeevika	जीविका
Jeevitha	जीविथा
Jenya	जेन्या
Jesal	जेसल
Jetashri	जेताश्री
Jhalak	झलक
Jharna	झरना
Jhilmil	झिलमिल
Jhinuk	झिनूक
Jigisha	जिगीषा
Jigna	जिग्ना
Jignasa	जिग्नासा
Jigya	जिग्या
Jigyasa	जिज्ञासा
Jilpa	जिल्पा
Jinal	जिनल
Jithya	जिथ्या
Jivika	जीविका
Jiya	जिया
Joel	जोएल
Joshika	जोशिका
Joshita	जोशीता
Joshitha	जोशिथा
Jovita	जोविता
Jowaki	जोवाकी
Juana	जुअना
Juhi	जूही
Jui	जुई
Juily	जुइली
Jumaana	जमाना
Jwala	ज्वाला
Jyeshtha	ज्येष्ठ
Jyoti	ज्योति
Jyotibala	ज्योतिबाला
Jyotika	ज्योतिका
Jyotirmayi	ज्योतिर्मयी
Jyotirmoyee	ज्योतिर्मोयी
Jyotishmati	ज्योतिषमति
Jyotsna	ज्योत्सना
Kaamil	कामिल
Kabir	कबीर
Kadamb	कदम्ब
Kadeem	कदीम
Kaditula	कदितुला
Kahill	काहिल
Kailas	कैलास
Kailash	कैलाश
Kailashchandra	कैलाशचंद्र
Kailashnath	कैलाशनाथ
Kairav	कैरव
Kaivalya	कैवल्य
Kaladhar	कलाधर
Kalanath	कलानाथ
Kalap	कलाप
Kalapriya	कलाप्रिया
Kalash	कलश
Kal-hans	कल-हंस
Kalicharan	कालीचरण
Kalidas	कालिदास
Kalimohan	कालिमोहन
Kalipada	कालिपदा
Kaliranjan	कालिरंजन
Kalith	कालित
Kaliya	कालिया
Kalpa	कल्पा
Kalya	काल्या
Kalyan	कल्याण
Kamadev	कामदेव
Kamal	कमाल
Kamalaj	कमलाज
Kamalakar	कमलाकर
Kamalaksh	कमालाक्ष
Kamalanayan	कमलनयन
Kamalapati	कमलापति
Kamalbandhu	कमालबंधू
Kamalesh	कमलेश
Kamalkant	कमलकांत
Kamalnath	कमलनाथ
Kamalnayan	कमलनयन
Kaman	कमान
Kamat	कामत
Kamboj	कंबोज
Kamesh	कामेश
Kamik	कामीक
Kamlesh	कमलेश
Kamod	कमोद
Kamraj	कामराज
Kamran	कामरान
Kamsantak	कमसंतक
Kamukh	कामुख
Kanad	कनद
Kanaiya	कनैया
Kanak	कनक
Kanal	कनल
Kanan	कानन
Kanchan	कंचन
Kandan	कंदन
Kandarp	कंदर्प
Kandarpa	कंदर्प
Kanha	कान्हा
Kanhaiya	कन्हैया
Kanhaiyalal	कन्हैयालाल
Kanish	कनिश
Kanishk	कनिष्क
Kanishka	कनिष्का
Kanishta	कनिश्टा
Kanj	कंज
Kantilal	कांतिलाल
Kantimoy	कंतिमोय
Kanu	कनु
Kanv	कांव
Kanvar	कंवर
Kanwal	कंवल
Kanwaljeet	कंवलजीत
Kanwalkishore	कंवलकिशोरे
Kapali	कपाली
Kapi	कापी
Kapidhwaj	कपिध्वज
Kapil	कपिल
Kapil Dev	कपिलदेव
Kapilashwar	कपिलाश्वर
Kapish	कपीश
Karan	करन
Kareem	करीम
Karika	कारिका
Karim	करीम
Karna	करना
Karnik	कार्निक
Kartar	करतार
Kartik	कार्तिक
Kartikeya	कार्तिकेय
Karun	करुण
Karunakar	करुनाकर
Karunamay	कऋूणामय
Karunashankar	करुनाशंकर
Kashif	काशीफ़
Kashinath	काशीनाथ
Kashiprasad	काशिप्रसाद
Kashyap	कश्यप
Kasish	कशिश
Kathith	कथित
Katyayan	कात्यायन
Kaunteya	कौन्तेय
Kausar	कौसर
Kaushal	कौशल
Kaushik	कौशिक
Kaustav	कौस्तव
Kaustubh	कौस्तुभ
Kautik	कौतिक
Kautilya	कौटिल्य
Kavan	कवन
Kaveesha	कवीषा
Kavel	कवेल
Kavi	कवि
Kavin	कविन
Kavindra	कवीन्द्र
Kaviraj	कविराज
Kavish	कविश
Kayan	कयान
Kayosh	कयोश
Kedar	केदार
Kedarnath	केदारनाथ
Keshav	केशव
Keshto	केश्तो
Ketak	केतक
Ketan	केतन
Ketu	केतु
Ketubh	केतुभ
Keva	केवा
Keval	केवल
Kevalkishore	केवलकिशोरे
Kevalkumar	केवलकुमार
Keyur	केयूर
Khadim	खादिम
Khair Udeen	खैर उदीन
Khairy	खैरी
Khajit	खाजित
Khaldoon	खल्दून
Khaleel	खलील
Khalid	ख़ालिद
Khazana	ख़ज़ाना
Khemchand	खेमचंद
Khemprakash	खेमप्रकाश
Khushal	ख़ुशाल
Khuzaymah	खुज़य्माह
Kinshuk	किंशुक
Kiran	किरण
Kiranmay	किरंमय
Kiratidev	किरतीदेव
Kirik	किरीक
Kirin	किरिन
Kirit	किरीट
Kiritmani	किरिटमणि
Kirtan	कीर्तन
Kirtibhushan	किर्तिभुशन
Kirtikumar	किर्तिकुमार
Kirtin	किर्तिन
Kirtinath	कीर्थिनाथ
Kirtivallabh	किर्तिवल्लभ
Kishor	किशोर
Kishore	किशोर
Kishorekumar	किशोरेकुमार
Koshin	कोशिन
Kotijit	कोटीजित
Koundinya	कौंदिन्य
Kovida	कोविदा
Kovidh	कोविद
Kranti	क्रांति
Kriday	क्रिदय
Kripal	कृपाल
Kripanidhi	कृपानिधि
Kripasagar	कृपासागर
Krish	क्रिश
Krishang	क्रिशंग
Krishanu	क्रिशानु
Krishna	कृष्णा
Krishnachandra	कृश्णाचंद्रा
Krishnadeva	कृष्नदेवा
Krishnakanta	कृष्णकाँता
Krishnakumar	कृष्णकुमार
Krishnala	कृष्णला
Krishnamurari	कृष्णमुरारी
Krishnamurthy	कृष्णामूर्ति
Krishnaroop	कृष्णरूप
Krishnendu	क्रिश्नेंदु
Kritanu	क्रिताणु
Krithik	क्रिथिक
Krivi	क्रिवी
Krunal	कृनल
Kshaunish	क्षौनिश
Kuber	क़ुबेर
Kuberchand	कुबेरचंद
Kularanjan	कुलरंजन
Kulbhushan	कुलभूषण
Kuldeep	कुलदीप
Kulik	क्यूलिक
Kuljit	कुलजित
Kulveer	कुलवीर
Kulvinder	कुलविंदर
Kulvir	कुलवीर
Kumar	कुमार
Kumush	कुमुश
Kunal	कुणाल
Kundan	कुंदन
Kundanlal	कुंदनलाल
Kundir	कुंदीर
Kunja	कुंजा
Kunjabihari	कुंजबीहारी
Kunsh	कुंश
Kunshi	कुंशी
Kunwar	कुंवर
Kunwarjeet	कुंवरजीत
Kusagra	कुसाग्र
Kush	कुश
Kushabahu	कुशाबहु
Kushad	कुषद
Kushal	कुशल
Kushanu	कुशानु
Kusumakar	कुसुमकर
Kusumesh	कुसुमेश
Kuvam	कुवम
Kuvar	कुवर
Kuwarjeet	कुवारजीत
Kvanh	क्वांह
Kaamla	कामला
Kaasni	कासनी
Kadambari	कादम्बरी
Kadambini	कादम्बिनी
Kadhiroli	काधिरोली
Kahini	कहिनी
Kaia	किया
Kairavi	कैरवी
Kaishori	कैशोरी
Kajal	काजल
Kajjali	कज्जाली
Kajol	काजोल
Kajri	कजरी
Kakali	ककली
Kakoli	काकोली
Kaksi	काक्सी
Kala	कला
Kalaimagal	कलैमगल
Kalaka	कालका
Kalakarni	कलाकरनी
Kalandhika	कलांधिका
Kalanidhi	कलानिधि
Kalapi	कालपी
Kalapini	कलापिनी
Kalavati	कलावती
Kali	काली
Kalika	कालिका
Kalima	कालिमा
Kalindi	कालिंदी
Kalini	कालिनी
Kalka	कालका
Kallol	कल्लोल
Kalpana	कल्पना
Kalpini	कल्पिनी
Kalpita	कल्पिता
Kalya	कल्या
Kalyani	कल्याणी
Kamadha	कमाधा
Kamakshi	कामाक्षी
Kamakya	कामक्या
Kamal	कमाल
Kamala	कमला
Kamalakshi	कमलाक्षी
Kamali	कमली
Kamalika	कमलिका
Kamalini	कमलिनी
Kamalkali	कमलकली
Kamana	कामना
Kameela	कमीला
Kameshvari	कामेश्वरी
Kamika	कामिका
Kamini	कामिनी
Kamitha	कामिथा
Kamna	कम्ना
Kampana	कंपना
Kamya	काम्या
Kana	काना
Kanak	कनक
Kanaka	कनक
Kanakabati	कनकाबती
Kanakapriya	कनकप्रिया
Kanaklata	कानकलता
Kanakpriya	कनकप्रिया
Kanan	कानन
Kananbala	काननबाला
Kanasu	कानासु
Kanchan	कंचन
Kanchana	कंचना
Kanchi	काँची
Kandhal	कांधल
Kandhara	कंधारा
Kangana	कंगना
Kani	कानी
Kanika	कनिका
Kanimoli	कनिमोली
Kanira	कनिरा
Kanitha	कनिता
Kanizah	कनिजः
Kanjari	कंजरी
Kanjri	कंजरी
Kankalini	कन्कालिनी
Kankana	कंकना
Kanmani	कन्मानी
Kannaki	कन्नाकी
Kanta	कांता
Kanti	कांति
Kanupriya	कनुप्रिया
Kanushi	कानुशी
Kanya	कन्या
Kanyakumari	कन्याकुमारी
Kanyana	कन्याना
Kapalini	कपालिनी
Kapardini	कपार्दिनी
Kapila	कपिला
Kapotakshi	कपोताक्षी
Karabi	करबी
Karala	कराला
Karalika	करालिका
Kareema	करीमा
Kareena	करीना
Karishma	करिश्मा
Karka	कर्का
Karla	कार्ला
Karnapriya	कर्नाप्रिया
Karuka	कारूका
Karuli	करूली
Karuna	करूणा
Karunamayee	करुनामई
Karunamayi	करुणामयी
Karunya	करुन्या
Kashi	काशी
Kashika	काशिका
Kashish	कशिश
Kashmira	काश्मीरा
Kashvi	कश्वी
Kashwini	कश्विनी
Kashyapi	कश्यापी
Kasturi	कस्तूरी
Katyayani	कात्ययानी
Kaumudi	कौमुदी
Kausalya	कौसल्या
Kaushali	कौशाली
Kaushalya	कौशल्या
Kaushika	कौशिका
Kaushiki	कौशिकी
Kaustubhi	कौस्तुभी
Kautirya	कौतिर्य
Kavana	कवाना
Kaveri	कावेरी
Kavika	कविका
Kavin	कविन
Kavini	कविनी
Kavita	कविता
Kaviya	कविया
Kavni	कवनी
Kavya	काव्या
Kawkab	कव्काब
Kawthar	कव्थर
Kayalvili	कायलविली
Keemaya	कीमाया
Kenga	केंगा
Kenisha	केनिषा
Kerani	करनी
Kesar	केसर
Kesari	केसरी
Keshi	केशी
Keshika	केशिका
Keshini	केशिनी
Keshori	केशोरी
Ketaki	केतकी
Ketana	केतना
Ketika	केतिका
Ketki	केतकी
Keva	केवा
Keya	केया
Keyuri	केयुरी
Khadeeja	खदीजा
Khairiya	खैरिया
Khalida	खालिदा
Khanika	खनिका
Khawlah	खाव्लाह
Khulood	खुलूद
Khushboo	खुश्बू
Khyath	ख्यात
Khyati	ख्याति
Kiah	कइः
Kilimoli	किलीमोली
Kimatra	किमात्रा
Kimaya	किमाया
Kina	किना
Kinari	कीनारी
Kinjal	किंजल
Kinnari	किन्नरी
Kinnera	किन्नेरा
Kiran	किरण
Kiranmala	किरणमाला
Kiranmayi	किरंमयी
Kirati	कीर्ति
Kirtana	कीर्तना
Kirthana	कीर्थना
Kirthi	कीर्थी
Kirti	कीर्ति
Kirtmalini	किर्तमालिनी
Kiruba	किरुबा
Kishmish	किशमिश
Kishori	किशोरी
Kitu	कितु
Kiya	किया
Kokila	कोकिला
Komal	कोमल
Komala	कोमला
Komali	कोमाली
Kouther	कौथेर
Koyel	कोएल
Krandasi	क्रंदासी
Kranti	क्रांति
Krina	क्रिना
Kripa	कृपा
Kripi	कृपी
Krisha	क्रिषा
Krishi	कृषि
Krishna	कृष्णा
Krishnakali	क्रिश्नाकली
Krishnaveni	क्रिश्नावेनी
Krithi	कृति
Krithya	कृथ्य
Kriti	कृति
Krittika	कृत्तिका
Kritu	कृतु
Kriya	क्रिया
Krupa	कृपा
Krupali	कृपाली
Kruti	कृति
Ksema	क्सेमा
Kshama	क्षमा
Kshamya	क्षम्या
Kshanaprabha	क्षनाप्रभा
Kshanika	क्षणिका
Kshema	क्षेमा
Kshemya	क्षेम्या
Kshipa	क्षिपा
Kshipra	क्षिप्रा
Kshipva	क्षिप्वा
Kshiraja	क्शिराजा
Kshirin	क्षिरिन
Kshirja	क्षिरजा
Kshithi	क्षिति
Kshiti	क्षिति
Kshitija	क्षितिज
Kuja	कुजा
Kulthoom	कुल्थूम
Kumari	कुमारी
Kumkum	कुमकुम
Kumud	कुमुद
Kumuda	कुमुदा
Kumudini	कुमुदिनी
Kunda	कुन्दा
Kundan	कुंदन
Kundanika	कुंदनीका
Kundini	कुंदिनी
Kunisha	कुनिषा
Kunjal	कुंजल
Kunjalata	कुंजलता
Kunjana	कुंजना
Kunshi	कुंशी
Kuntal	कुंतल
Kuntala	कुंतला
Kunti	कुंती
Kurangi	कुरंगी
Kurinji	कुरिंजी
Kushala	कुशाला
Kusum	कुसुम
Kusuma	कुसूमा
Kusumanjali	कुसुमंजलि
Kusumavati	कुसुमावती
Kusumita	कुसुमीता
Kusumlata	कुसूमलता
Kuvalai	कुवलाई
Kuvam	कुवम
Kuvira	कुविरा
Kuyil	कुईल
Kuyilsai	कुईल्सैई
Kyna	क्य्ना
Labeeb	लाबीब
Labh	लाभ
Lagan	लगान
Lahar	लहर
Lakhan	लखन
Laksh	लक्ष
Lakshan	लक्षण
Lakshanya	लक्षन्य
Lakshin	लक्षिण
Lakshman	लक्ष्मण
Lakshmibanta	लक्ष्मिबंता
Lakshmidhar	लक्ष्मीधर
Lakshmigopal	लक्ष्मीगोपाल
Lakshmikant	लक्ष्मीकांत
Lakshmikanta	लक्ष्मीकांता
Lakshminarayan	लक्ष्मीनारायण
Lakshmipati	लक्ष्मीपति
Lakshmiraman	लक्ष्मिरमण
Lakshya	लक्ष्य
Lalam	ललाम
Lalamani	लालमणि
Lalit	ललित
Lalitaditya	ललितादित्य
Lalitchandra	ललितचंद्रा
Lalitkishore	ललितकिशोरे
Lalitkumar	ललितकुमार
Lalitmohan	ललितमोहन
Lambodar	लंबोदर
Lankesh	लंकेश
Latafat	लतफ़ट
Latif	लतीफ़
Lavana	लवना
Lavanya	लावण्या
Likhit	लिखित
Liladhar	लीलाधर
Lochan	लोचन
Lohendra	लोहेंद्र
Lohit	लोहित
Lohitaksha	लोहीतक्षा
Lohitashwa	लोहिताश्वा
Lokajit	लोकाजित
Lokakriti	लोकाकृति
Lokanetra	लोकनेत्र
Lokapujya	लोकापुज्य
Lokbhushan	लोक्भुशन
Lokesh	लोकेश
Loknath	लोकनाथ
Lokpradeep	लोकप्रदीप
Lokprakash	लोकप्रकाश
Lokranjan	लोकरंजन
Lomash	लोमश
Lu'ay	लू'आय
Lukesh	लुकेश
Luqmaan	लुकमान
Lutfi	लुत्फी
Luv	लव
Labangalata	लबांगलता
Labha	लाभा
Laboni	लबोनी
Labuki	लाबुकी
Ladhi	लाधी
Ladli	लाडली
Laghima	लाघिमा
Laghuvi	लघुवी
Laila	लैला
Lajita	लजिता
Lajja	लज्जा
Lajjawati	लज्जावती
Lajvanti	लाजवंती
Lajvati	लाजवती
Lajwanti	लाजवन्ती
Lajwati	लाजवती
Lakhi	लखी
Laksha	लक्षा
Lakshaki	लक्षाकी
Lakshana	लक्षणा
Lakshanya	लाक्षन्य
Lakshita	लक्षिता
Lakshmi	लक्ष्मी
Lakshmishree	लक्ष्मीश्री
Lakshya	लक्ष्य
Lalamani	लालमणि
Lalan	लालन
Lalana	लालना
Lalasa	लालसा
Lali	लाली
Lalima	लालीमा
Lalita	ललिता
Lalitamohana	ललितामोहना
Lama	लामा
Lamees	लमीस
Lamya	लम्या
Laranya	लारान्य
Lasaki	लासकी
Lasya	लास्य
Lata	लता
Latakara	लताकारा
Latangi	लतांगी
Lateefa	लतीफा
Latika	लतिका
Lavali	लवली
Lavangi	लवंगी
Lavani	लावनी
Lavanya	लावण्या
Lavenia	लावेनिया
Laxmi	लक्ष्मी
Leela	लीला
Leelamayee	लीलामई
Leelavati	लीलावती
Leena	लीना
Leena	लीना
Lekha	लेखा
Lekisha	लेकिषा
Leora	लेओरा
Libni	लिब्नी
Lilavati	लीलावती
Lilly	लिल्ली
Lily	लिली
Lipi	लिपि
Lipika	लीपिका
Lochan	लोचन
Lochana	लोचना
Lohini	लोहिनी
Lohita	लोहीता
Lokajanani	लोकाजनानी
Lokamatri	लोकामात्री
Lola	लोला
Lolita	लोलिता
Lona	लोना
Lopa	लोपा
Lopamudra	लॉपमुद्रा
Loukya	लौक्य
Lubaaba	लुबाबा
Lubaina	लुबैना
Lucia	लुसिया
Lumbika	लुम्बिका
Maahir	माहिर
Maazin	माजिन
Madan	मदन
Madanapal	मदनपाल
Madangopal	मदनगोपाल
Madanmohan	मदनमोहन
Maderu	मदेरू
Madesh	मदेश
Madhav	माधव
Madhavan	माधवन
Madhavdas	माधव दास
Madhu	मधु
Madhuban	मधुबन
Madhuchanda	मधुचंदा
Madhuk	मधुक
Madhukant	मधुकांत
Madhukanta	मधुकांता
Madhukar	मधुकर
Madhumay	मधुमय
Madhup	मधुप
Madhur	मधुर
Madhusudan	मधुसूदन
Madhusudhana	मधुसुधना
Madin	मदीन
Madur	मदुर
Magadh	मगध
Magan	मगन
Magh	माघ
Mahabahu	महाबाहू
Mahabala	महाबाला
Mahadev	महादेव
Mahaj	महाज
Mahakaya	महाकाया
Mahaketu	महाकेतु
Mahakram	महाक्रम
Mahamani	महामानी
Mahamati	महामति
Mahanidhi	महानिधि
Mahaniya	महानिया
Mahant	महंत
Mahanth	महंत
Mahapurush	महापुरुष
Maharanth	महारंथ
Maharath	महारत
Maharshi	महर्षि
Maharth	महार्थ
Mahasvin	महस्विन
Mahatru	महात्रू
Mahavir	महावीर
Mahdy	महदी
Maheepati	महीपति
Mahendra	महेंद्रा
Mahesh	महेश
Maheshwar	महेश्वर
Mahijith	महीजित
Mahin	महीन
Mahinder	महिंदर
Mahindra	महिंद्रा
Mahipal	महिपाल
Mahipati	महिपति
Mahir	माहिर
Mahish	महीष
Mahit	माहित
Mahith	माहित
Mahmoud	महमूद
Mahmud	महमूद
Mahtab	महतब
Mainak	मैनाक
Mairava	मैरवा
Maitreya	मैत्रेया
Majd	मज्द
Majd Udeen	मज्द उदीन
Majdy	मज्दय
Makarand	मकरंद
Makeen	मकीन
Makhesh	मखेश
Makrand	मकरंद
Makul	माक़ूल
Makur	मकुर
Malank	मलांक
Malav	मालव
Malay	मलय
Malhar	मल्हार
Mallesh	मल्लेश
Malolan	मालोलन
Mamdouh	मम्दौह
Mamnoon	ममनून
Mamraj	मामराज
Manajith	मनजीत
Manan	मनन
Manas	मानस
Manasi	मानसी
Manasyu	मानस्यू
Manav	मानव
Manavendra	मानवेन्द्र
Mandan	मंदन
Mandar	मंदार
Mandeep	मनदीप
Mandhata	मान्धाता
Mandhatri	मन्धात्री
Mandin	मंदिन
Mandir	मंदिर
Mandith	मंदिथ
Maneet	मनीत
Manendra	मानेन्द्र
Mangal	मंगल
Mangesh	मंगेश
Manhar	मनहर
Mani	मणि
Manibhushan	मनिभूषण
Manidhar	मनिधर
Manik	मनिक
Manikandan	मनिकंदन
Manikant	मणिकांत
Manindra	मनीन्द्र
Manipal	मणिपाल
Maniram	मनिराम
Manish	मनीष
Manishankar	मणिशंकर
Manit	मानित
Manith	मनित
Manjeet	मनजीत
Manjot	मनजोत
Manjughosh	मंजुघोश
Manjul	मंजुल
Manmatha	मन्मथ
Manmeet	मनमीत
Manmohan	मनमोहन
Mannan	मनन
Mannath	मन्नत
Mannith	मन्नीत
Manohar	मनोहर
Manoj	मनोज
Manojavaya	मनोजवाया
Manomay	मनोमय
Manonith	मनोनीत
Manoranjan	मनोरंजन
Manorath	मनोरथ
Manoth	मनोथ
Manprasad	मानप्रसाद
Mansour	मन्सौर
Mansukh	मनसुख
Manth	मंथ
Manthan	मंथन
Mantram	मंत्रम
Manu	मनु
Manuj	मनुज
Manuraj	मनुराज
Manvendra	मानवेन्द्र
Manvir	मनविर
Manyu	मन्यु
Maral	मराल
Mardav	मार्दव
Mareechi	मारीची
Markandeya	मारकँडेया
Martand	मार्तंड
Martanda	मार्तान्दा
Marudeva	मारुदेवा
Marut	मारुत
Maruti	मारुति
Marwan	मरवान
Marzouq	मरजौक
Masoud	मासौद
Matanga	मातंगा
Matheysh	मठेय्श
Matsendra	मत्सेंद्र
Matsyendra	मत्स्येंद्र
Maulik	मौलिक
Mayank	मयंक
Mayanka	मयँका
Mayon	मयोन
Maysarah	मय्सरह
Mayukh	मयूख
Mayur	मयूर
Medhansh	मेधंश
Meer	मीर
Megh	मेघ
Megha	मेघा
Meghaj	मेघाज
Meghashyam	मेघश्याम
Meghdutt	मेघदुत्त
Meghnad	मेघनाद
Megh-nad	मेघ-नाद
Meghraj	मेघराज
Mehan	महान
Mehboob	मेहबूब
Mehdi	मेहदी
Meherdad	मेहेरदाद
Mehmood	महमूद
Mehtab	महताब
Mehul	मेहुल
Mekhal	मेखल
Meru	मेरू
Mihir	मिहिर
Mihirkiran	मिहिरकिरण
Mikesh	मिकेश
Mikhail	मिखाइल
Mikul	मिकुल
Milan	मिलन
Miland	मिलंद
Milap	मिलाप
Milind	मिलिंद
Milit	मिलित
Milun	मिलुन
Minesh	मिनेश
Mirza	मिर्ज़ा
Misal	मिसाल
Misbaah	मिस्बाह
Misri	मिसरी
Mitansh	मितांश
Miten	मितेन
Mitesh	मितेश
Mithil	मिथिल
Mithilesh	मितिलेश
Mithran	मिथ्रण
Mithun	मिथुन
Mitra	मित्रा
Mitrajit	मित्रजित
Mitul	मितुल
Moazzem	मोअज्जेम
Modak	मोदक
Moh	मोह
Mohajit	मोहाजीत
Mohak	मोहक
Mohal	मोहल
Mohamad	मोहमद
Mohan	मोहन
Mohin	मोहीन
Mohinder	मोहिंदर
Mohit	मोहित
Mohnish	मोहनीश
Mohul	मोहुल
Monish	मोनीष
Moorti	मूर्ती
Moosa	मूसा
Moti	मोती
Motilal	मोतीलाल
Moulik	मौलिक
Mridul	मृदुल
Mriga	मृगा
Mrigaj	मृगाज
Mrigalochan	मृगलोचन
Mrigank	मृगांक
Mriganka	मृगंका
Mrigankamouli	म्रिगंकमौली
Mrigankasekhar	म्रिगंकसेखर
Mrigasya	मृगस्य
Mrigendra	मृगेन्द्र
Mrigesh	मृगेश
Mrinal	मृणाल
Mrinank	मृनांक
Mrinendra	म्रिनेंद्र
Mritunjay	मृतुन्जय
Mrityunjay	मृत्युंजय
Muaath	मुआत
Muayid	मुईद
Mubarak	मुबारक
Mudgal	मुद्गल
Mudil	मुदिल
Mudit	मुदित
Mudita	मुदिता
Mufeed	मुफीद
Muhamad	मुहमद
Muhammad	मुहम्मद
Muhannad	मुहंनद
Muhsin	मुहसिन
Muhtady	मुह्तादय
Mujaahid	मुजाहिद
Mukesh	मुकेश
Mukhtaar	मुख्तार
Muktananda	मुक्तानंदा
Mukul	मुकुल
Mukund	मुकुंद
Mukunda	मुकुंदा
Mukut	मुकुट
Mulkraj	मुल्कराज
Mumtaz	मुमताज़
Muneer	मुनीर
Muni	मुनि
Munindra	मुनीन्द्र
Munish	मुनीष
Muntasir	मुन्तासिर
Munthir	मुन्थिर
Murad	मुराद
Murali	मुरली
Muralidhar	मुरलीधर
Muralimanohar	मुरलीमनोहर
Murari	मुरारी
Murarilal	मुरारीलाल
Murgesh	मुर्गेश
Murli	मुरली
Murtadhy	मुर्तादति
Murugan	मुरुगन
Musad	मुसाद
Musheer	मुशीर
Muslim	मुस्लिम
Mustafa	मुस्तफा
Mustaq	मुस्ताक
Mutaa	मुता
Mutasim	मुतासिम
Mutazz	मुताज्ज़
Mutee	मुती
Muwafaq	मुवाफक
Madeeha	मदीहा
Madhavi	माधवी
Madhavilata	माधविलता
Madhu	मधु
Madhubala	मधुबाला
Madhuchanda	मधुचंदा
Madhuchhanda	मधुछंदा
Madhuja	मधुजा
Madhuksara	मधुक्सरा
Madhul	मधुल
Madhula	मधुला
Madhulata	मधुलता
Madhulekha	मधुलेखा
Madhulika	मधुलिका
Madhumalati	मधुमालती
Madhumathi	मधुमथी
Madhumati	मधुमति
Madhumita	मधुमिता
Madhumitha	मधुमिता
Madhunisha	मधुनिषा
Madhupriya	मधुप्रिया
Madhur	मधुर
Madhura	मधुरा
Madhuri	माधुरी
Madhurima	मधुरिमा
Madhushri	मधुश्री
Madhuvanthi	मधुवंथी
Madina	मदीना
Madira	मदिरा
Madirakshi	मदिराक्षी
Madri	माद्री
Madura	मदुरा
Magadhi	मागधी
Magana	मगना
Maghi	मघी
Maha	महा
Mahabhadra	महाभाद्रा
Mahadevi	महादेवी
Mahaganga	महागंगा
Mahagauri	महागौरी
Mahajabeen	महाज़बीन
Mahakali	महाकाली
Mahakanta	महाकांता
Mahalakshmi	महालक्ष्मी
Mahamaya	महामाया
Mahasri	महस्री
Mahasweta	महास्वेता
Mahati	महती
Maheshi	महेशी
Maheshwari	महेश्वरी
Mahi	माही
Mahijuba	महिज़ुबा
Mahika	महीका
Mahima	महिमा
Mahita	महिता
Mahitha	महीथा
Mahiya	माहिया
Mahua	महुआ
Mahubala	महुबाला
Maimoona	मैमूना
Maina	मैना
Maisa	मिसा
Maithili	मैथिली
Maitra	मैत्रा
Maitreya	मैत्रेया
Maitreyi	मैत्रेयी
Maitri	मैत्री
Maitry	मैत्री
Majeeda	मजीदा
Majida	मजिदा
Makaarim	मकारिम
Makali	मकाली
Makshi	माक्षी
Mala	माला
Malak	मालक
Malarvili	मालारविली
Malashree	मालाश्री
Malati	मालती
Malavika	मालविका
Malaya	मलया
Maliha	मलिहा
Malika	मालिका
Malina	मालिना
Malini	मालिनी
Malka	मल्का
Malli	मल्ली
Malliga	मल्लिगा
Mallika	मल्लिका
Malti	मालती
Malvika	मालविका
Mamata	ममता
Mamta	ममता
Mana	मना
Manaal	मनाल
Manaar	मनार
Manadha	मानाधा
Manaka	मानका
Manal	मनल
Manali	मनाली
Manana	मानना
Mananya	मनन्य
Manasa	मनसा
Manasi	मानसी
Manasika	मानसिका
Manasvi	मनस्वी
Manasvini	मनस्विनी
Manavi	मनावी
Manayi	मानायी
Manda	मंदा
Mandakini	मंदाकिनी
Mandakranta	मंदाक्रांता
Mandana	मंदना
Mandara	मंदरा
Mandarmalika	मंदार्मालिका
Mandavi	मांडवी
Mandeepa	मंदीपा
Mandira	मंदिरा
Manditha	मंदिथा
Mandodari	मंदोदरी
Mandra	मंदरा
Mangai	मंगाई
Mangala	मंगला
Mangalya	मांगल्य
Manideepa	मनिदीपा
Manik	मनिक
Manika	मणीका
Manikuntala	मनिकुन्ताला
Manimala	मणिमाला
Manimekhala	मनिमेखला
Manini	मनीनी
Maniratna	मणिरत्ना
Manisha	मनीषा
Manishika	मनिशिका
Manisi	मानीसी
Manisila	मानीसिला
Manisitha	मनिसिथा
Manitha	मनीता
Maniya	मनिया
Manjari	मंजरी
Manjira	मंजीरा
Manjistha	मंजिस्था
Manju	मंजू
Manjubala	मंजुबाला
Manjula	मंजुला
Manjulika	मंजुलिका
Manjusha	मंजूशा
Manjushri	मंजुश्री
Manjusri	मंजुश्री
Manjyot	मनज्योत
Manmayi	मन्मायी
Manna	मन्ना
Manorama	मनोरमा
Manoranjana	मनोरंजना
Manoritha	मनोरिथा
Manshree	मनश्री
Mansi	मानसी
Manthika	मंथिका
Mantra	मंत्रा
Manushri	मनुश्री
Manya	मान्या
Maraam	मराम
Marala	मरला
Mareesha	मरीषा
Margi	मार्गी
Marichi	मारिची
Marichika	मारिचिका
Marisa	मारिसा
Markandeya	मारकँडेया
Marsha	मार्षा
Marudham	मारुधाम
Maruff	मरुफ्फ़
Marushika	मारुशिका
Marya	मार्या
Maryam	मरयम
Masara	मसरा
Masilmani	मासिलमणि
Masum	मासूम
Matangi	मातंगी
Matisha	मतिषा
Matra	मात्रा
Matrika	मात्रिका
Mausam	मौसम
Mausami	मौसमी
Maushmi	मौश्मी
Mausumi	मौसुमी
Mawiya	मविया
May	माय
Maya	माया
Mayil	माइल
Mayra	मायरा
Maysaa	मय्सा
Maysoon	माय्सून
Mayukhi	मायुखी
Mayura	मयूरा
Mayuri	मयूरी
Mayurika	मयूरिका
Mayyada	माय्यादा
Medh	मेध
Medha	मेधा
Medhani	मेधानी
Medhya	मेध्या
Medini	मेदिनी
Meena	मीना
Meenakshi	मीनाक्षी
Meenal	मीनल
Meera	मीरा
Meeza	मीज़ा
Megan	मेगान
Megha	मेघा
Meghamala	मेघमाला
Meghana	मेघना
Meghavini	मेघविनी
Mehak	महक
Mehal	मेहल
Meharunnisa	महरुन्निसा
Mehbooba	मेहबूबा
Meher	मेहेर
Mehrunissa	मेहरुनिस्सा
Mehul	मेहुल
Mehuli	मेहुली
Mekhala	मेखला
Mela	मेला
Mena	मीना
Menaha	मेनहा
Menaja	मेनाजा
Menaka	मेनका
Menitha	मेनिता
Menmoli	मेनमोली
Mihika	मिहीका
Mihira	मिहिरा
Milana	मिलना
Mili	मिली
Milika	मिलिक़ा
Mina	मीना
Minakshi	मीनाक्षी
Minal	मीनल
Minati	मिनती
Minnoli	मिन्नोली
Mira	मीरा
Miraya	मिराया
Mirium	मिरियम
Misha	मिशा
Mishaye	मिशाये
Mishita	मिशिता
Mishti	मिष्टी
Misri	मिसरी
Mita	मिता
Mitali	मिताली
Miteelai	मितीलाई
Mithi	मीठी
Mithra	मित्रा
Mohana	मोहना
Mohini	मोहिनी
Mohisha	मनीषा
Mohita	मोहिता
Mohitha	मोहिता
Moksha	मोक्षा
Moksin	मोक्सिन
Molina	मोलिना
Mona	मोना
Monal	मोनल
Monica	मोनिका
Monisha	मोनीषा
Mridini	मृदिनी
Mridu	मृदु
Mridula	मृदुला
Mrigakshi	मृगाक्षी
Mriganayani	मृगनयनी
Mrinal	मृणाल
Mrinali	मृणाली
Mrinalika	मृनालिका
Mrinalini	मृणालिनी
Mrinmayee	मृन्मयी
Mrinmayi	म्रिन्मायी
Mritsa	मृत्सा
Mrittika	मृत्तिका
Mruda	मृदा
Mrudani	मृदानी
Mrudu	मृदु
Mrudula	मृदुला
Mubashshara	मुबश्शारा
Mubinah	मुबिनाह
Mudra	मुद्रा
Mudrika	मूद्रिका
Mufeeda	मुफीदा
Mugdha	मुग्धा
Muhja	मुह्जा
Mukta	मुक्ता
Mukti	मुक्ति
Mukul	मुकुल
Mukula	मुकुला
Mukulita	मुकुला
Mullai	मुल्लाई
Muna	मुना
Muneera	मुनीरा
Muniya	मुनिया
Musheera	मुशीरा
Muskan	मुस्कान
Muthammal	मुथाम्मल
Mutholi	मुतोली
Muthunagai	मुथुनागाई
Mythily	म्य्थिली
Naadir	नादिर
Naag	नाग
Naa'il	ना' इल
Naajy	नाहिद
Naasih	नासिह
Naathim	नाथिम
Nabarun	नबरूण
Nabeeh	नबीह
Nabeel	नबील
Nabendu	नबेंदु
Nabhan	नाभन
Nabhanyu	नभान्यु
Nabhas	नाभस
Nabhi	नाभि
Nabhij	नब्हिज
Nabhith	नाभित
Nabhoj	नभोज
Nabhomani	नभोमानी
Nabhya	नाभ्या
Nachik	नाचिक
Nachiket	नाचिकेत
Nachiketa	नचिकेता
Nadal	नादल
Nadeem	नदीम
Nadeen	नदीन
Nadeesh	नदीश
Nadin	नादीन
Nadir	नादिर
Nadish	नदिश
Naeem	नईम
Nagander	नागंदर
Nagarin	नागरीन
Nagarjun	नागार्जुन
Nagdhar	नागधर
Nagendra	नागेन्द्र
Nagesh	नागेश
Nageshwaran	नागेश्वरण
Naggar	नाग्गर
Nagpal	नागपाल
Nagpati	नागपति
Nag-raj	नाग-राज
Nahid	नाहिद
Nahush	नहुष
Nahusha	नहुषा
Naimish	नैमिष
Nairit	नैरित
Naishadh	नैषध
Najeeb	नजीब
Najm Udeen	नज्म उदीन
Nakesh	नाकेश
Nakhraj	नाखराज
Nakir	नकिर
Naksatraraja	नक्सत्रराजा
Nakshatra	नक्षत्रा
Nakul	नकूल
Nal	नल
Nalesh	नलेश
Nalin	नलिन
Nalinaksh	नालिनाक्ष
Nalinaksha	नलिनक्षा
Nalinikant	नालिनिकांत
Naman	नमन
Namasyu	नमस्यू
Nambi	नांबी
Namdev	नामदेव
Namish	नमीश
Namit	नामित
Nanak	नानक
Nand	नंद
Nanda	नंदा
Nandak	नंदक
Nandakishor	नंदकिशोर
Nandakumar	नंदकुमार
Nandan	नंदन
Nandi	नंदी
Nandin	नंदिन
Nandish	नंदिश
Nand-kishore	नन्द-किशोर
Nandlal	नंदलाल
Nand-nandan	नंद-नंदन
Naotau	नाओटौ
Narad	नारद
Narahari	नरहरी
Narasimha	नरसिंहा
Narayan	नारायण
Narayana	नारायाणा
Narayanan	नारायणन
Narendra	नरेन्द्र
Narendranath	नरेन्द्रनाथ
Naresh	नरेश
Narhari	नरहरी
Narinder	नरिन्दर
Narmad	नर्मद
Narottam	नरोत्तम
Narsi	नरसी
Narsimha	नरसिंहा
Nartan	नर्तन
Nartana	नर्ताना
Narun	नारून
Naruna	नारुना
Naseem	नसीम
Nashir	नशिर
Nasser Udeen	नस्सेर उदीन
Natesh	नतेश
Nateshwar	नातेश्वर
Nathan	नाथन
Natheer	नाथीर
Nathin	नातिन
Natraj	नटराज
Natwar	नटवर
Naubahar	नौबहार
Nauhar	नोहर
Navaj	नवाज
Naval	नवल
Navalan	नवालन
Navaneet	नवनीत
Navashen	नवाशें
Naveen	नविन
Navendu	नवेंदु
Navin	नवीन
Navinchandra	नाविनचंद्र
Navjot	नवजोत
Navnit	नवनीत
Navrang	नवरंग
Navratan	नवरतन
Navroz	नवरोज़
Navtej	नवतेज
Nawalkishor	नवलकिशोर
Nawfal	नवफा
Nayakan	नायकन
Nayan	नयन
Nayath	नयथ
Nazeeh	नजीह
Nedumaan	नेदुमान
Nedumaran	नेदुमारण
Neel	नील
Neelabh	नीलाभ
Neeladri	नीलाद्री
Neelam	नीलम
Neelamani	नीलमणि
Neelambar	नीलाम्बर
Neelambuj	नीलाम्बुज
Neelanchal	नीलांचल
Neelanjan	नीलंजन
Neelesh	नीलेश
Neelgreev	नीलग्रीव
Neelkanta	नील कांता
Neelkanth	नीलकांत्
Neelmadhav	नील माधव
Neelmani	नीलमणि
Neelotpal	नीलोत्पल
Neeraf	नीरफ़
Neeraj	नीरज
Nibodh	निबोध
Nidhish	निधीश
Nigam	निगम
Nihal	निहाल
Nihar	निहार
Nikash	नीकश
Niket	निकेत
Niketan	निकेतन
Nikhat	निखत
Nikhil	निखिल
Nikhilesh	निखिलेश
Nikunj	नीकुंज
Nikunja	नीकुंजा
Nilabh	नीलाभ
Nilay	नीलय
Nilesh	निलेश
Nimai	निमाई
Nimai	निमाई
Nimesh	निमेश
Nimish	निमिष
Ninad	निनाद
Nipun	निपुण
Nirad	नीरद
Niraj	नीरज
Nirajit	निराजित
Niral	निरल
Niramay	निरामय
Niramitra	निरमित्रा
Niranjan	निरंजन
Nirankar	निरंकार
Nirav	नीरव
Nirbhay	निर्भय
Nirbhik	निर्भीक
Nirdhar	निर्धार
Nirek	निरेक
Nirijhar	निरिजार
Nirish	निरिश
Nirmal	निर्मल
Nirmalya	निर्माल्य
Nirmanyu	निर्मन्यु
Nirmay	निर्मय
Nirmit	निर्मित
Nirmohi	निर्मोही
Nirupam	निरुपं
Nirvan	निर्वाण
Nisarg	निसर्ग
Nischal	निश्चल
Nischith	निश्चित
Nish	निष्
Nishad	नीषद
Nishakant	निशाकांत
Nishakar	निशाकर
Nishanath	निशानाथ
Nishant	निशांत
Nishar	निषर
Nishat	निशात
Nishchal	निश्चल
Nishesh	निशेष
Nishikant	निशाकांत
Nishikanta	निशिकाँता
Nishikar	निशाकर
Nishil	निशील
Nishinath	निशिनाथ
Nishit	निशित
Nishita	निशिता
Nishith	निशीथ
Nishkama	निष्कामा
Nishkarsh	निष्कर्ष
Nishok	निशोक
Nissim	निस्सीम
Nisyanthan	निसयान्थान
Niteesh	नीतीश
Nitesh	नितेश
Nithik	नीतिक
Nithilan	नीतीलन
Nitin	नितिन
Nitish	नीतीश
Nityagopal	नित्यगोपाल
Nityanand	नित्यानंद
Nityananda	नित्यानंदा
Nityanta	नित्यंता
Nityasundar	नित्यासुन्दर
Nitya-Sundara	नित्य-सुन्दर
Nivrutti	निवृत्ति
Niyath	नियत
Nooh	नूह
Noor Udeen	नूर उदीन
Noori	नूरी
Nridev	न्रिदेव
Nrip	नृप
Nripa	नृपा
Nripendra	नृपेन्द्र
Nripesh	न्रिपेश
Nrupadh	न्रुपध
Nu'man	नु'मन
Naaz	नाज़
Nabah	नाबह
Nabeeha	नाबीहा
Nabeela	नाबीला
Nabhanya	नाभंया
Nabhitha	नाभिता
Nabhya	नाभया
Nachni	नाचनी
Nada	नाडा
Nadeeda	नादीदा
Nadia	नदिया
Nadira	नादिरा
Nadwa	नाद्वा
Naeema	नईमा
Nafeesa	नफीसा
Nafrin	नाफ्रिन
Naganandini	नागानंदिनी
Naganika	नागानिका
Nagashree	नगश्री
Nagina	नगीना
Nagini	नागिनी
Nahla	नाहला
Naidhrua	नैढ्रुआ
Naija	नैजा
Naila	नैला
Naima	नेमा
Naimah	नैमाह
Naina	नैना
Nainika	नैनिका
Naisha	नैषा
Naishadha	नैशाधा
Najaah	नजाह
Najat	नजात
Najeeba	नाजीबा
Najiya	नाजिया
Najla	नजला
Najma	नजमा
Najwa	नाज्वा
Najya	नाज्य
Nakti	नाक्ति
Nakula	नकुला
Nalika	नलिका
Nalina	नलिना
Nalini	नलिनी
Namana	नमना
Nami	नामी
Namita	नमीता
Namrah	नम्रह
Namrata	नम्रता
Namuchi	नामुची
Namya	नम्या
Nanaki	नानकी
Nanda	नंदा
Nandana	नंदना
Nandika	नंदिका
Nandini	नंदिनी
Nandita	नंदिता
Nangai	नंगाई
Naomi	नाओमी
Naomika	नोमिका
Narayani	नारायणी
Narmada	नर्मदा
Narois	नारोईस
Nartan	नर्तन
Naseen	नसीन
Nashida	नशिदा
Nashita	नशिता
Nasiha	नासिहा
Nasira	नासिर
Natasha	नताशा
Natun	नतुन
Nauka	नौका
Navadurga	नवदुर्गा
Navaneeta	नवनीता
Navdeep	नवदीप
Naveena	नवीना
Navika	नाविका
Navistha	नाविस्था
Navita	नविता
Naviya	नाविया
Navneeta	नवनीता
Navya	नाव्य
Nawal	नवाल
Nawar	नवार
Nayana	नयना
Nayantara	नयनतारा
Nayonika	नयोनिका
Nazaaha	नाजाहा
Nazarha	नज़र्हा
Nazeeha	नज़ीहा
Nazeena	नज़ीना
Nazeera	नजीरा
Nazeeya	नाजीया
Nazia	नाजिया
Nazima	नज़िमा
Nazimah	नाज़िमः
Nazma	नजमा
Neeharika	नीहारिका
Neela	नीला
Neelabja	नीलाब्जा
Neelaja	नीलाजा
Neelakshi	नीलाक्षी
Neelam	नीलम
Neelanjana	नीलंजना
Neelima	नीलिमा
Neelja	नील्जा
Neelkamal	नीलकमल
Neelkamala	नीलकमाला
Neena	नीना
Neepa	नीपा
Neeraja	नीरजा
Neeta	नीता
Neeti	नीति
Neha	नेहा
Nehal	नेहल
Neharika	नेहारिका
Nesayem	नेसयेम
Netra	नेत्रा
Netravati	नेत्रवती
Nibaal	निबाल
Nida	निदा
Nidhi	निधि
Nidhipa	निधिपा
Nidhyana	निध्याना
Nidhyathi	निध्याथी
Nidra	निद्रा
Niharika	निहारिका
Niju	निजु
Nikara	निकारा
Nikhila	निखिला
Nikhita	निखिता
Nikki	निक्की
Nila	नीला
Nilakshi	नीलाक्षी
Nilambari	निलाम्बरी
Nilaruna	निलारूना
Nilasha	निलाशा
Nilashri	निलाश्री
Nilavoli	निलावोली
Nilaya	निलाया
Nileen	निलीन
Nilima	निलीमा
Nilini	निलिनी
Niloufer	निलौफ़ेर
Nilshikha	निलशिखा
Nimaat	निमात
Nimisha	निमिषा
Nimita	निमिता
Nimmi	निम्मी
Nina	नीना
Ninarika	निनारिका
Nipa	निपा
Nipeksha	निपेक्षा
Niradhara	निराधार
Niraimadhi	निरैमधि
Niral	निरल
Nirali	निराली
Niramayee	निरामई
Niranjana	निरंजना
Nirguna	निर्गुना
Nirja	नीरजा
Nirmala	निर्मला
Nirmayi	निरमई
Nirmitha	निर्मिता
Nirupa	निरूपा
Nirupama	निरुपमा
Nirvana	निर्वाना
Nisha	निशा
Nishay	निशय
Nishi	निशि
Nishithini	निशिथिनी
Nishka	निश्का
Nishtha	निष्ठा
Nistha	निष्ठा
Nita	नीता
Nitara	नितारा
Nitha	नीथा
Nithilam	निथिलम
Nithya	नित्या
Niti	नीति
Nitika	नितिका
Nitima	नितिमा
Nitu	नितु
Nitya	नित्या
Nityapriya	नित्याप्रिया
Nityasri	नित्यासरी
Nivedita	निवेदिता
Niverta	निवेरता
Nivriti	निवृति
Nivritti	निवृत्ति
Niyati	नियती
Noopur	नूपुर
Noor	नूर
Noor	नूर
Noorien	नूरिएन
Noorjehan	नूरज़ेहान
Noshi	नोशी
Nouf	नौफ
Nudhar	नुधर
Nuha	नुहा
Nupura	नुपूरा
Nurjahan	नूरजहाँ
Nusayba	नुसय्बा
Nusrat	नुसरत
Nutan	नूतन
Nuti	नूती
Nuzha	नुज्हा
Obalesh	ओबलेश
Oha	ओहा
Ohas	ओहस
Ojas	ओजस
Ojayit	ओजयित
Om	ओम
Oma	ओम
Omair	ओमैर
Omanand	ओमानंद
Omar	ओमर
Omarjeet	ओमरजीत
Omeir	ओमिर
Omesa	ओमेसा
Omesh	ओमेश
Omeshwar	ओमेश्वर
Omja	ओम्जा
Omkar	ओमकार
Omkarnath	ओमकारनाथ
Ompati	ओमपति
Omprakash	ओमप्रकाश
Omran	ओमरन
Omswaroop	ओमस्वरूप
Oni	ओनी
Oojam	ऊजम
Oorjit	ऊर्जित
Oppilmani	ओप्पिलमणि
Ori	ऑरी
Orion	ओरिओन
Ossama	ओसामा
Ottakoothan	ओत्तकूथन
Oviyan	ओवियान
Odathi	ओदथी
Oditi	ओदिती
Oindrila	ओंद्रिला
Oja	ओजा
Ojal	ओज़ल
Ojasvi	ओजस्वी
Ojaswini	ओजस्विनी
Oma	ओमा
Omaja	ओमाजा
Omala	ओमला
Omana	ओमना
Omisha	ओमिषा
Omkareshwari	ओमकारेश्वरी
Omkari	ओमकारी
Omvati	ओमवती
Oni	ओनी
Orpita	ओर्पिता
Oviya	ओविया
Paavan	पावन
Pachai	पचाई
Pachaimani	पचैमानी
Pachaimuthu	पचैमुथु
Padam	पदम
Padm	पद्म
Padmabandhu	पद्मबंधू
Padmadhar	पद्मधर
Padmahasta	पद्महस्ता
Padmaj	पद्माज
Padmakant	पद्मकांत
Padmakar	पद्माकर
Padmalochan	पद्मलोचन
Padman	पदमन
Padmanabh	पद्मनाभ
Padmanabha	पद्मनाभा
Padmapani	पद्मपानी
Padmapati	पद्मापति
Padmayani	पद्मायानी
Padmesh	पदमेश
Padminish	पद्मिनिश
Pahal	पहल
Paksha	पक्ष
Palak	पलक
Palani	पलानी
Palaniappan	पालनियप्पन
Palanikumar	पलानिकुमार
Palanimurugan	पलानिमुरुगन
Palanisami	पलानिसमी
Palanivel	पालनीवेल
Palash	पलाश
Palashkusum	पलाशकुसूम
Palashranjan	पलाशरंजन
Palin	पालिन
Pallab	पल्लब
Pallav	पल्लव
Panav	पनव
Panchajana	पंचाजना
Panchal	पंचाल
Panchanan	पंचानन
Panchavaktra	पंचावक्त्र
Pandhari	पंधारी
Pandita	पंडिता
Pandu	पांडू
Pandurang	पांडुरंग
Panduranga	पान्दुरंगा
Pandya	पंड्या
Panine	पाणिनी
Panini	पाणिनी
Pankaj	पंकज
Pankajalochana	पंकजलोचना
Pankajan	पंकजन
Pankajeet	पंकजीत
Panmoli	पानमोली
Pannalal	पन्नालाल
Pann-gesh	पण-गेश
Panshul	पंशुल
Parag	पराग
Parakram	पराक्रम
Param	परम
Paramananda	परमानंदा
Paramartha	परमार्थ
Paramesh	परमेश
Parameshwar	परमेश्वर
Param-hans	परम-हंस
Paramhansa	परमहंसा
Paramjeet	परमजीत
Paramjit	परमजीत
Paran	परन
Paranjay	परान्जय
Parantapa	परंतापा
Paras	पारस
Parashar	पराशर
Parashuram	परशुराम
Parasmani	पारसमानी
Parasme	परसमे
Paratpara	परात्पर
Paravasu	परवासू
Parbrahm	पारब्रह्म
Parees	परीस
Paresh	परेश
Paresha	परेशा
Pari	पारी
Parighosh	परिघोश
Parijat	पारिजात
Pariket	परिकेत
Parikshit	परिक्षित
Parimal	परिमल
Parin	पॅरिन
Parindra	परिंद्रा
Paritosh	पारितोश
Parmarth	परमार्थ
Parmeet	परमीत
Parmesh	परमेश
Parminder	परमिंदर
Parnad	पर्नाद
Parth	पार्थ
Partha	पार्था
Parthapratim	पार्थाप्रतिम
Parthasarathi	पार्थसारथी
Parthiv	पार्थिव
Parvat	पर्वत
Parvateshwar	पर्वतेश्वर
Parvatinandan	पार्वती नंदन
Parvesh	परवेश
Parwez	परवेज़
Pashunath	पशुनाथ
Pashupati	पशुपति
Pasupati	पसुपति
Patag	पतग
Patakin	पताकिन
Patanjali	पतंजलि
Pathik	पथिक
Pathin	पथिन
Patoj	पतोज
Patr	पत्र
Patralika	पत्रलिका
Paurav	पौरव
Pavak	पावक
Pavalan	पवालन
Pavan	पवन
Pavanaj	पवानाज
Pavani	पावनी
Pavankumar	पवनकुमार
Pavanputra	पवनसुत
Pavansut	पवनसुत
Pavitra	पवित्र
Payas	पयास
Payod	पयोद
Peeyush	पीयूष
Pehlaj	पहलाज
Perumal	पेरुमल
Phalak	फलक
Phalgun	फ़ाल्गुन
Phani	फनी
Phanibhusan	फनिभुसन
Phaninath	फनिनाथ
Phanindra	फनिंद्र
Phanindranath	फनिन्द्रनाथ
Phanishwar	फनिश्वर
Phenil	फेनिल
Phoolendu	फूलेंदु
Pinak	पीनाक
Pinaki	पिनाकी
Pinakin	पिनाकिन
Pingal	पिंगल
Pirmohammed	पिरमोहम्मेद
Pitambar	पीताम्बर
Piyush	पीयूष
Ponnan	पोंनन
Poojan	पूजन
Poojit	पूजीत
Poonish	पूनिश
Pooran	पूरण
Poorna	पूर्णा
Poornachandra	पूर्नाचंद्रा
Poornanand	पूर्नानंद
Poorv	पूर्व
Poorvaj	पूर्वज
Prabal	प्रबल
Prabhakar	प्रभाकर
Prabhanjan	प्रभंजन
Prabhas	प्रभास
Prabhat	प्रभात
Prabhav	प्रभाव
Prabhave	प्रभाव
Prabhu	प्रभु
Prabir	प्रबीर
Prabodh	प्रबोध
Prabodhan	प्रबोधन
Prabuddha	प्रबुद्ध
Prachet	प्रचेत
Pracheta	प्रचेता
Prachetas	प्रचेतास
Prachur	प्रचुर
Pradarsh	प्रदर्श
Pradeep	प्रदीप
Pradhi	प्राधि
Pradnesh	प्रद्नेश
Pradosh	प्रदोष
Pradyot	प्रदयोत
Pradyumna	प्रद्युम्न
Pradyun	प्रदयुन
Praful	प्रफुल
Prafulla	प्रफुल्ला
Pragnya	प्रग्न्या
Pragun	प्रगुन
Prahalad	प्रहलाद
Prahallad	प्रहल्लाद
Prahlad	प्रहलाद
Prajapati	प्रजापति
Prajeet	प्रजीत
Prajesh	प्रजेश
Prajin	प्रजिन
Prajit	प्रजित
Prajit	पराजित
Prajval	प्रज्वल
Prajvala	प्रज्वला
Prakash	प्रकाश
Prakat	प्रकट
Praket	प्रकट
Prakhar	प्रखर
Prakrit	प्राकृत
Prakriti	प्राकृति
Prakul	प्राकुल
Pralay	प्रलय
Pramath	प्रमात
Pramesh	प्रमेश
Pramit	प्रमित
Pramod	प्रमोद
Pramodan	प्रमोदन
Pramsu	प्रम्सू
Pramukh	प्रमुख
Pran	प्राण
Prana	प्राण
Pranad	प्रनद
Pranav	प्रणव
Pranava	प्रणव
Pranay	प्रणय
Praneel	प्रनील
Praneeth	प्रनीथ
Pranesh	प्रनेश
Pranet	प्रनेत
Praney	प्रनेय
Pranit	प्रणित
Pranjal	प्रांजल
Pranjivan	प्राणजीवन
Prannath	प्राणनाथ
Pranshu	प्रन्शु
Pransu	प्रन्सू
Pransukh	प्रानसुख
Prasad	प्रसाद
Prasanna	प्रसन्ना
Prasata	प्रसता
Prasenjit	प्रसेंजित
Prasham	प्रषम
Prashant	प्रशांत
Prashanta	प्रशांता
Prashray	प्रश्रय
Prasiddhi	प्रसिद्धि
Prasoon	प्रसून
Prasun	प्रसून
Pratap	प्रताप
Prateek	प्रतीक
Prateep	प्रतीप
Prateet	प्रतीत
Prathamesh	प्रथमेश
Prathmesh	प्रथमेश
Pratik	प्रतीक
Pratiti	प्रतिती
Pratosh	प्रतोश
Pratul	प्रतुल
Pratyush	प्रत्यूष
Praval	प्रवल
Pravan	प्रवण
Pravar	प्रवर
Praveen	प्रवीण
Praveer	प्रवीर
Praver	प्रवेर
Pravin	प्रवीन
Pravir	प्रवीर
Pravit	प्रवित
Prayag	प्रयाग
Preetam	प्रीतम
Preetidutt	प्रीतिदुत्त
Preetish	प्रीतीश
Preetiwardhan	प्रीतिवर्धन
Prem	प्रेम
Premal	प्रेमल
Premanand	प्रेमानांद
Premendra	प्रेमेन्द्र
Prerit	प्रेरित
Pretvan	प्रेतवान
Pribhakta	प्रिभक्ता
Prina	प्रिना
Prineet	प्रिनीत
Prinita	परिणीता
Pritam	प्रीतम
Pritesh	प्रीतेश
Prithish	प्रीथिश
Prithu	प्रिथु
Prithvi	पृथ्वी
Prithvijaj	पृथ्विज़ज़
Prithviraj	पृथ्वीराज
Pritish	प्रीतिश
Privrata	प्रिव्रता
Priya	प्रिया
Priyabrata	प्रियब्रता
Priyadarshan	प्रियदर्शन
Priyadarshi	प्रियदर्शी
Priyaka	प्रियका
Priyank	प्रियांक
Priyanshu	प्रियांशु
Priyanvad	प्रियंवाद
Priyaranjan	प्रियरंजन
Priyesh	प्रियेश
Pruthivi	पृथिवी
Pugal	पुगल
Pugalendhi	पुगलेंधी
Pujan	पूजन
Pujit	पुजीत
Pukhraj	पुखराज
Pulak	पुलक
Pulakesh	पुलाकेश
Pulastya	पुलासत्य
Pulin	पुलिन
Pulish	पुलिश
Pulkit	पुलकित
Pundalik	पुन्दलिक
Pundarik	पुंदरीक
Puneet	पुनीत
Punit	पुनीत
Punyabrata	पुन्यब्रता
Punyasloka	पुन्यस्लोका
Purahan	पुरहण
Purajit	पुराजित
Puran	पुरान
Purandar	पुरंदर
Puranjay	पुरांजय
Purav	पूर्व
Purnanada	पुर्नानादा
Purnendu	पुर्नेंदु
Purohit	पुरोहित
Purshottam	पुरषोत्तम
Puru	पूरु
Purujit	पुरूजीत
Purumitra	पुरुमित्रा
Pururava	पुरुरवा
Purushottam	पुरुषोत्तम
Pusan	पुसन
Pushkal	पुष्कल
Pushkar	पुष्कर
Pushp	पुष्प
Pushpad	पुश्पद
Pushpaj	पुष्पज
Pushpak	पुष्पक
Pushpakar	पुष्पकर
Pushpaketu	पुष्पकेतु
Pushpesh	पुष्पेश
Pushp-mitra	पुष्प-मित्र
Puskara	पुस्कारा
Pyarelal	प्यारेलाल
Pyaremohan	प्यारेमोहन
Padma	पद्मा
Padmagriha	पद्मग्रिहा
Padmaja	पद्मजा
Padmajai	पद्माजई
Padmakali	पद्माकली
Padmakshi	पद्माक्षी
Padmal	पद्मल
Padmalaya	पद्मालय
Padmalochana	पद्मलोचना
Padmamalini	पद्ममालिनी
Padmapriya	पद्मप्रिया
Padmarekha	पद्मरेखा
Padmaroopa	पद्मारूपा
Padmashri	पद्मश्री
Padmavasa	पद्मवासा
Padmavati	पद्मावती
Padmini	पद्मिनी
Padnuni	पादनुनी
Pahal	पहल
Pakhi	पख़ी
Pakshalika	पक्षालिका
Pakshi	पक्षी
Palaksi	पलाकसी
Pallavi	पल्लवी
Pallavini	पल्लविनी
Palomi	पलोमी
Pameela	पमीला
Pamela	पामेला
Pampa	पम्पा
Panchali	पंचाली
Panita	पनिता
Pankaja	पंकज़ा
Pankajadharini	पंकाजधारिणी
Pankhudi	पंखुड़ी
Pankita	पंकिता
Pankti	पंक्ति
Panna	पन्ना
Panya	पान्या
Paola	पाओला
Parajika	पराजिका
Parama	परमा
Parameshwari	परमेश्वरी
Paramita	परामिता
Paravi	परावी
Parbarti	पर्बर्ती
Pari	परी
Paridhi	परिधि
Parina	परिना
Parinita	परिणीता
Parivita	परिविता
Pariyat	परियत
Parmila	परमिला
Parmita	पारमिता
Parnal	पर्नल
Parnashri	पर्नाश्री
Parnavi	पर्नवी
Parni	पर्णी
Parnik	पर्णिक
Parnika	पर्णिका
Parnita	पर्निता
Parthavi	पार्थावी
Parthivi	पार्थीवी
Parul	पारूल
Parvani	परवानी
Parvati	पार्वती
Parveen	परवीन
Parvini	पर्विनी
Pasha	पाशा
Pashupriya	पशुप्रिया
Patala	पताला
Patmanjari	पट मंजरी
Patralekha	पत्रलेखा
Paulomi	पौलोमी
Pauravi	पौरवी
Pavaki	पावकी
Pavana	पावना
Pavani	पावनी
Pavi	पवि
Payal	पायल
Payoja	पायोज़ा
Pehr	पहर
Phiroza	फ़िरोज़ा
Phoolan	फूलन
Phutika	फुतिका
Pia	पीया
Piki	पीकी
Pinakini	पिनाकिनी
Pinga	पिंगा
Pingala	पिंगला
Pingla	पिंगला
Pival	पिवाल
Pivari	पिवारी
Piyali	पियाली
Pooja	पूजा
Poonam	पूनम
Poorbi	पूरबी
Poornakamala	पूर्नाकमला
Poornima	पूर्णिमा
Poorva	पूर्वा
Poorvaganga	पूर्वगंगा
Poorvi	पूर्वी
Poushali	पौशाली
Prabha	प्रभा
Prabhada	प्रभादा
Prabhati	प्रभाती
Prabhavati	प्रभावती
Pracheeta	प्रचीता
Prachi	प्राची
Pradeepta	प्रदीप्ता
Pradnaya	प्रादनाया
Pradnya	प्राद्न्य
Prafula	प्रफुला
Pragalbha	प्रगालभा
Pragati	प्रगती
Pragnya	प्रगन्या
Pragya	प्रज्ञा
Pragyaparamita	प्रग्यपरामिता
Pragyawati	प्रग्यावती
Prajakta	प्राजक्ता
Prajna	प्रजना
Prakalpa	प्रकल्पा
Prakhya	प्राख्या
Prama	प्रमा
Pramada	प्रमदा
Pramila	प्रमिला
Pramiti	प्रामिति
Pranali	प्रणाली
Pranati	प्राणती
Pranavi	प्रनवी
Pranaya	प्रनाया
Praneeta	प्रनीता
Pranidhi	प्रनिधि
Pranita	प्रनिता
Pranjeeta	प्रानजीता
Pranvuta	प्रंवुता
Prapti	प्राप्ति
Prarthana	प्रार्थना
Prasana	प्रसना
Prashansa	प्रशंसा
Prashanthi	प्राशंथी
Prashanti	प्रशांति
Prasheetha	प्रशीथा
Prasheila	प्रशेइला
Prathysha	प्रत्यशा
Pratibha	प्रतिभा
Pratichi	प्रतीची
Pratigya	प्रतिज्ञा
Pratika	प्रतिका
Pratiksha	प्रतीक्षा
Pratima	प्रतिमा
Pratishtha	प्रतिष्ठा
Pratitha	प्रतिथा
Pratyusha	प्रत्युषा
Pravina	प्रवीना
Prayuta	प्रयुता
Preet	प्रीत
Preetha	प्रीथा
Preeti	प्रीति
Prem	प्रेम
Prema	प्रेमा
Premala	प्रेमला
Premila	प्रेमीला
Prerana	प्रेरणा
Prerna	प्रेरणा
Preshti	प्रेष्टि
Prestha	प्रेस्था
Preyasi	प्रेयसी
Prianka	प्रीअंका
Prina	प्रिना
Prinaka	प्रिनाका
Prisha	प्रिषा
Prita	प्रीता
Prital	प्रितल
Pritha	परीता
Prithika	प्रिथिका
Priti	प्रीति
Pritika	प्रितिका
Pritikana	प्रितिकाना
Pritilata	प्रितिलता
Priya	प्रिया
Priyadarshini	प्रियदर्शीनी
Priyadutta	प्रियादुत्ता
Priyal	प्रियल
Priyala	प्रियाला
Priyam	प्रियाँ
Priyamvada	प्रियंवदा
Priyanka	प्रियंका
Priyanvada	प्रियंवदा
Priyasha	प्रियाशा
Prutha	पृथा
Puja	पूजा
Puji	पूजी
Pujita	पुजीता
Pujya	पुज्या
Pulkita	पुल्किता
Puloma	पूलोमा
Punarnava	पुनर्नावा
Pundari	पुन्दारी
Puneet	पुनीत
Punita	पुनीता
Punthali	पुंथाली
Punya	पुन्या
Purala	पुराला
Purandhri	पुरान्धरी
Purnima	पूर्णिमा
Purva	पूर्वा
Purvaja	पूर्वज़ा
Purvi	पूर्वी
Pusha	पूषा
Pushpa	पुष्पा
Pushpagandha	पुष्पगंधा
Pushpalata	पुष्पलता
Pushpanjali	पुष्पंज़लि
Pushpavathi	पुश्पावथी
Pushpita	पुष्पिता
Pusti	पुस्ति
Putana	पूतना
Putul	पुतुल
Qasim	कासिम
Qatadah	क़तादः
Qays	क़य्स
Quamar	क़ुमर
Quasim	कुअसिम
Qudamah	क़ुदामाह
Qutaybah	कुताय्बह
Qutub	क़ुतूब
Quarrtulain	कुँर्र्तुलें
Quasar	कुअसर
Raakin	रामिज़
Raamiz	रामिज़
Raatib	रातिब
Rabah	रबह
Rabee	रबी
Rachit	रचित
Radhak	राधाक
Radhakanta	राधाकांता
Radhakrishna	राधाकृष्णा
Radhatanaya	राधा तनय
Radhavallabh	राधा वल्लभ
Radhesh	राधेश
Radheshyam	राधेश्याम
Radheya	राधेया
Ra'ed	र'एद
Rafat	रफत
Rafee'	रफी
Raghav	राघव
Raghavendra	राघवेन्द्र
Raghbir	रघबीर
Ragheb	रघेब
Raghu	रघु
Raghubir	रघुबीर
Raghukumara	रघुकुमारा
Raghunandan	रघुनन्दन
Raghunath	रघुनाथ
Raghupati	रघुपति
Raghuvir	रघुवीर
Ragin	रागिन
Rahas	रहस
Raheel	राहील
Raheem	रहीम
Rahi	राही
Rahil	राहील
Rahim	रहीम
Rahman	रहमान
Rahul	राहुल
Raivata	रैवता
Raivath	रैवत
Raj	राज
Raja	राजा
Rajab	रजब
Rajak	रजक
Rajan	राजन
Rajani	रजनी
Rajanikant	रजनीकांत
Rajanikanta	राजनीकाँता
Rajanya	राजन्य
Rajarshi	रजर्शी
Rajas	राजस
Rajat	रजत
Rajatanabhi	रजतानाभी
Rajatshubhra	रजत्शुभ्रा
Rajdeep	राजदीप
Rajender	राजेंदर
Rajendra	राजेंद्र
Rajendrakumar	राजेंद्रकुमार
Rajendramohan	राजेंद्रमोहन
Rajesh	राजेश
Rajevalochan	राजीवालोचन
Rajinder	राजिंदर
Rajinipati	रजिनिपति
Rajit	रजित
Rajiv	राजीव
Rajivalochana	राजीवालोचना
Rajkumar	राजकुमार
Rajnish	रजनीश
Rajrishi	रजर्शी
Raju	राजू
Rajul	राजुल
Rajyashree	राज्यश्री
Rajyeshwar	राज्येश्वर
Rakesh	राकेश
Raksha	रक्षा
Rakshan	रक्षण
Raktakamal	रक्ताकमल
Ram	राम
Ramadeep	रामादीप
Ramadhuta	रामाधुता
Ramakant	रमाकांत
Ramakanta	रमाकांता
Ramakrishna	रामकृष्णा
Raman	रमण
Ramanand	रामानंद
Ramandeep	रमनदीप
Ramanjit	रमनजित
Ramanpreet	रमनप्रीत
Ramanuj	रामानुज
Ramanuja	रामानुज़ा
Ramanveer	रमनवीर
Ramashray	रामाश्रय
Ramavatar	रामावतार
Ramchandra	रामचंद्रा
Ramdas	रामदास
Ram-datt	राम-दत्त
Rameez	रमीज़
Ramesh	रमेश
Rameshwar	रामेश्वर
Ramgopal	रामगोपाल
Ramith	रमित
Ramkishore	रामकिशोरे
Ramkrishna	रामकृष्णा
Ramkumar	रामकुमार
Rammohan	राममोहन
Ramnath	रामनाथ
Ramoji	रामोजी
Ramprasad	रामप्रसाद
Rampratap	रामप्रताप
Ramra	रामरा
Ramratan	रामरतन
Ramswaroop	रामस्वरूप
Rana	राना
Ranadeva	रनादेवा
Ranajay	रनाज़य
Ranajit	रणजीत
Ranak	रनक
Randeep	रणदीप
Randhir	रणधीर
Ranesh	रानेश
Rangan	रंगन
Ranganath	रंगनाथ
Rangith	रंगित
Ranjan	रंजन
Ranjay	रंजय
Ranjeet	रणजीत
Ranjit	रंजीत
Ranjiv	रंजिव
Rantidev	रंतिदेव
Ranveer	रणवीर
Rasaraj	रसराज
Rasbihari	रासबिहारी
Rasesh	रसेश
Rashad	राशद
Rashid	रशीद
Rashmil	रश्मील
Rasik	रसिक
Rasul	रसूल
Rasul aidil	रसूल एदिल
Ratan	रतन
Ratannabha	रतन्नाभा
Rathik	रतीक
Rathin	रथिन
Ratinderpal	रतिन्देरपल
Ratish	रतीश
Ratnabhu	रत्नाभु
Ratnakar	रत्नाकर
Ratnanidhi	रत्नानिधि
Ratnesh	रत्नेश
Ratul	रतुल
Ravalnath	रावलनाथ
Raven	रवेन
Ravi	रवि
Ravikanth	रविकांत
Ravikeerti	रविकीर्ती
Ravikiran	रवीकिरण
Ravinandan	रविनंदन
Ravindra	रवींद्र
Ravindranath	रविंद्रनाथ
Ravinshu	रविन्शु
Ravish	रवीश
Ravisharan	रविशरण
Ravishu	रविशु
Ravit	रवित
Ravoof	रवूफ़
Ray	राय
Rayirth	रईर्थ
Raza	रज़ा
Razak	रज़ाक
Rebanta	रेबांता
Regender	रेगेनदर
Rehaan	रेहान
Rehan	रेहान
Rehman	रेहमान
Rehmat	रेहमात
Rehyaaz	रेह्याज़
Renaud	रेनौद
Renesh	रेनेश
Renit	रेनित
Revanth	रेवंथ
Riddhiman	रिद्धिमान
Ridha	रिधा
Ridhwan	रिध्वन
Ridit	रिदित
Rigved	ऋग्वेद
Rijul	रिजूल
Rikin	रिकिन
Ripu	रिपु
Ripudaman	रीपुदमान
Rishab	रिस्हब
Rishabh	रिषभ
Rishan	रिशान
Rishi	ऋषि
Rishikesh	ऋषिकेश
Rishit	रिषित
Rishvanjas	रिश्वंजास
Ritesh	रितेश
Rithik	रितिक
Rituparan	रितुपराण
Rituraj	रितुराज
Ritvik	ऋत्विक
Rivan	रीवन
Riyadh	रियाध
Riyaz	रियाज़
Riyyan	रिय्यान
Rizvan	रिज़वान
Rizvi	रिज़वी
Rochak	रोचक
Rochan	रोचन
Rohak	रोधक
Rohan	रोहन
Rohanlal	रोहनलाल
Rohiniraman	रोहिनिरमण
Rohinish	रोहिनिश
Rohit	रोहित
Rohitasva	रोहितास्व
Rohtak	रोहतक
Romir	रोमिर
Ronak	रोनक
Ronav	रोनव
Ronith	रोनित
Ronsher	रोनशेर
Roopak	रूपक
Roshan	रोशन
Ruchir	रुचिर
Rudr	रुद्र
Rudra	रुद्रा
Ruhan	रूहान
Rujul	रूजूल
Rukm	रुक्म
Rukma	रुकमा
Rukminesh	रुक्मिनेश
Rupak	रूपक
Rupang	रुपंग
Rupendra	रुपेंद्र
Rupesh	रूपेश
Rupeshwar	रुपेश्वर
Rupin	रुपिन
Rushabh	रुशभ
Rusham	रुषम
Rushan	रुशन
Rushang	रुशंग
Rusheek	रुशीक
Rushil	ऋशील
Rustam	रुस्तम
Rustom	रुस्तोम
Rutajit	रुताजित
Rutesh	रुतेश
Rutujit	रुतुजित
Rutva	रुत्वा
Rutvij	रुत्विज
Rwiju	र्विजू
Raaida	रैदा
Raawiya	राविया
Rabab	रबाब
Rabeea	राबीया
Rabhya	राभ्या
Rabia	राबिया
Rachana	रचना
Rachita	रचिता
Rachna	रचना
Radha	राधा
Radhana	राधना
Radhani	राधानी
Radhika	राधिका
Radhiyaa	रधिया
Radhwa	राध्वा
Raeleah	रैलेः
Rafa	रफा
Rafia	रफिया
Raghd	राघ्द
Ragi	रागी
Ragini	रागिनी
Rahela	राहेला
Raima	रायमा
Rajalakshmi	राजालक्ष्मी
Rajam	राजम
Rajani	रजनी
Rajanigandha	रजनीगंधा
Rajashri	राजश्री
Rajasi	राजसी
Rajata	राजता
Rajdulari	राजदुलारी
Rajeshri	राजेश्री
Rajeshwari	राजेश्वरी
Rajhans	राजहंस
Rajhansa	राजहंसा
Raji	राजी
Rajika	राजिका
Rajitha	रजिता
Rajivini	राजीविनी
Rajkumari	राजकुमारी
Rajnandhini	राजनंधिनी
Rajnandini	राजनंदिनी
Rajni	रजनी
Rajshri	राजश्री
Rajul	राजुल
Raka	राका
Rakhi	राखि
Raksha	रक्षा
Rakti	रक्ति
Rama	रमा
Ramana	रमाना
Ramani	रामानी
Rambha	रंभा
Rameshwari	रमेश्वरी
Ramila	रमिला
Ramini	रामिनी
Ramita	रमिता
Ramola	रमोला
Ramra	रामरा
Ramya	राम्या
Rand	रन्द
Rangana	रंगना
Rangitha	रंगिथा
Ranhita	रंहिता
Ranhitha	रंहिथा
Rani	रानी
Ranita	रानीता
Raniya	रानिया
Ranjana	रंजना
Ranjika	रंजिका
Ranjini	रंजिनी
Ranjita	रंजीता
Ranjudeep	रंजुदीप
Ranvitha	रन्विथा
Ranya	रन्य
Rasha	राषा
Rasheeda	रशीदा
Rashi	राशि
Rashmi	रश्मि
Rashmika	रश्मिका
Rasika	रसिका
Rasna	रसना
Ratanjali	रतांजलि
Rathika	रतिका
Rati	रती
Ratna	रत्ना
Ratnabala	रत्नाबाला
Ratnabali	रत्नाबली
Ratnajyoti	रत्नाज्योती
Ratnajyouti	रत्नाज्यौती
Ratnalekha	रत्नालेखा
Ratnali	रत्नाली
Ratnamala	रत्नमाला
Ratnangi	रत्नांगी
Ratnaprabha	रत्नप्रभा
Ratnapriya	रत्नाप्रिया
Ratnavali	रत्नावली
Ratri	रात्रि
Raveena	रवीना
Raviprabha	रविप्रभा
Rawdha	राव्धा
Raya	रया
Rebha	रेभा
Reem	रीम
Reema	रीमा
Reena	रीना
Rehwa	रेहवा
Rekha	रेखा
Reman	रेमान
Reneeka	रेनीका
Renu	रेणु
Renuka	रेणुका
Resham	रेशम
Reshika	रेशिका
Reshma	रेश्मा
Reshmi	रेश्मी
Reva	रेवा
Revathi	रेवथी
Revati	रेवती
Rewa	रेवा
Ria	रिया
Richa	ऋचा
Richitha	रिचीथा
Riddhi	रिद्धि
Ridhima	रिधिमा
Rihana	रिहाना
Riju	रीजू
Riju	रिजू
Rijuta	रिजुता
Rima	रीमा
Rina	रीना
Rinkal	रिन्कल
Risha	रिषा
Rishika	ऋषिका
Rishima	रिशिमा
Rishma	रिश्मा
Rishmitha	रिश्मिथा
Rita	रीटा
Rithika	ऋतिका
Riti	रीति
Ritika	रितिका
Ritisha	रितिषा
Ritsika	रितसिका
Ritu	रीतू
Rituparna	रितुपर्ना
Riya	रिया
Rochi	रोची
Rohana	रोहाना
Rohin	रोहिन
Rohini	रोहीनी
Rohita	रोहिता
Rolee	रोली
Roma	रोमा
Romila	रोमिला
Roop	रूप
Roopa	रूपा
Roopali	रूपाली
Roopini	रूपिनी
Roshan	रोशन
Roshna	रोशना
Roshni	रोशनी
Rubaina	रूबैना
Rucha	रुचा
Ruchi	रुचि
Ruchika	रुचिका
Ruchira	रुचिरा
Ruchita	रुचिता
Ruchitha	रूचिता
Rudrabhiravi	रुद्रभिरावी
Rudrakali	रुद्रकाली
Rudrani	रुद्राणी
Rudrapriya	रुद्रप्रिया
Rugu	रुगु
Ruhi	रूही
Ruhika	रूहिका
Ruhin	रुहीन
Rujula	रूजुला
Rujuta	रुजुता
Rukan	रुकान
Rukhmini	रुख्मिनी
Rukma	रूक़मा
Rukmini	रुक्मिनी
Ruksana	रुक्साना
Ruma	रूमा
Runa	रुना
Rupa	रूपा
Rupal	रूपल
Rupali	रुपाली
Rupashi	रूपाशी
Rupashri	रूपाश्री
Rupasi	रुपासी
Rupeshwari	रुपेश्वरी
Rupi	रूपी
Rupika	रुपिका
Ruqaya	रुकाया
Rusham	रुषम
Rushda	रुश्दा
Ruth	रुथ
Rutva	रुत्वा
Ruwayda	रुवायदा

Saabir	साबिर
Saad	साद
Saahir	साहिर
Saajid	साजिद
Saalih	सालिह
Saariyah	सारियाह
Sabal	सबल
Sabarinathan	सबरिनाथन
Sabeeh	सबीह
Sabhya	सभ्या
Sabrang	सबरंग
Sacchidananda	सच्चिदानंदा
Sachchit	सच्चित
Sachet	सचेत
Sachetan	सचेतन
Sachh	सछ
Sachin	सचिन
Sachish	सचिश
Sachit	सचित
Sachiv	सचिव
Sadabindu	सदबिंदु
Sadaiappan	सदैअप्पन
Sadanand	सदानंद
Sadar	सादर
Sadashiv	सदाशिव
Sadashiva	सदाशिवा
Sadavir	सदाविर
Sadeepan	सदीपन
Sadeeq	सादीक
Sadgun	सद्गुण
Sadhan	साधन
Sadhil	सधिल
Sadiq	सादिक़
Sadiva	सदिवा
Sadru	सदरु
Saeed	सईद
Safal	सफल
Saffar	सफ्फर
Safiy	सफीय
Safwan	सफ्वान
Sagan	सगन
Sagar	सागर
Sagardutt	सागरदत्त
Sagun	सगुण
Sahaj	सहज
Sahar	सहर
Sahara	सहारा
Saharsh	सहर्ष
Sahas	साहस
Sahasrad	सहस्रद
Sahastrabahu	सहस्त्रबाहु
Sahastrajit	सहस्त्रजित
Sahasya	सहस्य
Sahat	सहत
Sahay	सहाय
Sahaya	सहाय
Sahdev	सहदेव
Sahen	सहेन
Sahib	साहिब
Sahil	साहिल
Sahir	साहिर
Sahishnu	सहिष्णु
Sai Satpurusha	साई सत्पुरुषा
SaiAmartya	साई अमर्त्य
Saicharan	साई चरण
SaiDeep	साई दीप
Saif	सैफ
SaiJeevadhara	साई जीवधरा
SaiKalakala	साई कलाकाला
SaiKalateeta	साई कलातीता
Saikiran	साई किरण
Sainath	साईनाथ
Saiprasad	साईप्रासाद
Saipratap	साईप्रताप
Sajal	सजल
Sajan	साजन
Sajiv	सजीव
Sajiva	सजीव
Sajjan	सज्जन
Saju	सजू
Sakaleshwar	सकलेश्वर
Sakar	साकार
Sakash	साक्ष
Saket	साकेत
Saketharaman	सकेथारमण
Sakshum	सक्षम
Salah	सलाह
Salah Udeen	सलाह उदीन
Salaj	सलज
Salaman	सलमान
Salarjung	सलारजुंग
Saleem	सलीम
Salem	सलेम
Salil	सलिल
Salim	सलीम
Salman	सलमान
Salokh	सलोख
Samabashiv	समबशिव
Samaj	समज
Samajas	समाजस
Samantha	समानता
Samanyu	समन्यु
Samar	समर
Samarendra	समरेन्द्र
Samarendu	समरेंदु
Samarjit	समरजीत
Samarpan	समर्पण
Samarth	समर्थ
Samavart	समवर्त
Sambaran	समबरण
Sambha	साम्भा
Sambhav	संभव
Sambhddha	समभ्द्धा
Sambit	संबित
Sambodh	सम्बोध
Sambuddha	सम्बुद्धा
Samdarshi	समदर्शी
Sameen	समीन
Sameep	समीप
Sameer	समीर
Sameeullah	समीउल्लाह
Samen	समेन
Samendra	समेंद्र
Samendu	समेंदु
Samesh	समेश
Samgram	संग्राम
Sami	सामी
Samik	समिक
Samil	सामिल
Samin	समीन
Samir	समीर
Samir	समीर
Samiran	समिरन
Sammad	सम्माद
Sammath	संमत
Sampat	संपत
Sampath	संपथ
Sampoorn	सम्पूर्ण
Samrat	सम्राट
Samrudh	समृद्ध
Samskara	सम्स्कारा
Samudra	समुद्रा
Samudragupta	समुद्रगुप्ता
Samudrasen	समुद्रासेन
Samvar	संवार
Samvath	संवत
Samyak	सम्यक
Sanabhi	सनाभी
Sanam	सनम
Sanat	सनत
Sanatan	सनातन
Sanatana	सनातना
Sanchay	संचय
Sanchit	संचित
Sandananda	संदानंदा
Sandeep	संदीप
Sandeepan	संदीपन
Sandeepen	संदीपेन
Sandesh	संदेश
Sandy	संदी
Sangupt	सनगुप्त
Sanhata	संता
Sanjan	संजन
Sanjay	संजय
Sanjeev	संजीव
Sanjh	सांझ
Sanjit	संजीत
Sanjith	सांजीत
Sanjiv	संजीव
Sanjivan	संजीवन
Sanjog	संजोग
Sankalp	संकल्प
Sankalpa	संकल्प
Sankara	संकरा
Sankarshan	संकर्षण
Sanket	संकेत
Sannath	संनाथ
Sannigdh	संनिग्ध
Sanobar	सनोबर
Sanshray	संश्रय
Sanskar	संस्कार
Santan	संतान
Santosh	संतोष
Sanurag	सनुराग
Sanwariya	साँवरिया
Sanyog	संयोग
Sapan	सपान
Saprathas	सप्रात्हस
Saptajit	सप्ताजित
Saptanshu	सप्तान्शु
Saptarishi	सप्तरीशी
Saquib	साक़ुब
Saral	सरल
Sarana	सरना
Sarandeep	सरनदीप
Sarang	सारंग
Saransh	सारांश
Saras	सारस
Sarasija	सारसिज़ा
Sarasvat	सरस्वत
Sarat	शरद
Saravana	सरवना
Saravanan	सरवनन
Sarbajit	सरबजीत
Sarfaraz	सरफ़राज़
Sargam	सरगम
Sarin	सारिन
Sarish	सारिश
Sarngin	सर्नगिन
Saroj	सरोज
Sarojin	सरोजिन
Sartaj	सरताज
Sarthak	सार्थक
Sarup	सरूप
Sarva	सर्व
Sarvad	सर्वद
Sarvadaman	सर्वदामन
Sarvadev	सर्वदेव
Sarvadharin	सर्वधारिन
Sarvag	सर्वाग
Sarvagny	सर्वगन्य
Sarvak	सर्वक
Sarvambh	सर्वाम्भ
Sarvanavel	सर्वनवेल
Sarvang	सर्वांग
Sarvapalaka	सर्वपलाका
Sarvashay	सर्वशय
Sarvavas	सर्ववास
Sarvendra	सर्वेन्द्र
Sarvesh	सर्वेश
Sarveshvara	सर्वेश्वर
Sarwar	सर्वर
Sashang	सशंग
Sashanth	सशंथ
Sashreek	सश्रीक
Sashwat	साश्वत
Sasi	ससी
Sasidhar	ससिधर
Sasmit	सस्मित
Sasta	सस्ता
Satadev	सतादेव
Satamanyu	सतामन्यु
Satanand	सतानंद
Satatya	सातत्य
Satayu	सतायु
Sateendra	सतींद्र
Satesh	सतेश
Sathi	साथी
Sathindar	सथिंदर
Sathinder	सथिन्दर
Satin	सतीन
Satinath	सतीनाथ
Satindra	सतींद्रा
Satish	सतीश
Satishchandra	सतीशचन्द्र
Satkartar	सत्कर्तर
Satpal	सतपाल
Satpati	सत्पती
Satrajit	सत्रजित
Satrijit	सत्रिजित
Satrujit	सत्रुजित
Satvamohan	सत्वमोहन
Satvat	सतवत
Satveer	सतवीर
Satvik	सात्विक
Satvinder	सतविंदर
Satyadarshi	सत्यादर्शी
Satyadev	सत्यदेव
Satyajit	सत्यजीत
Satyak	सत्यक
Satyakam	सत्यकाम
Satyaki	सत्यकी
Satyam	सत्यम
Satyamurty	सत्य मूर्ती
Satyanarayan	सत्यनारायण
Satyankar	सत्यंकर
Satyaprakash	सत्य प्रकाश
Satyapriya	सत्याप्रिया
Satyashill	सत्य शील
Satyashrawa	सत्याश्रवा
Satyavache	सत्यावाचे
Satyavan	सत्यवान
Satyavrat	सत्यव्रत
Satyavrata	सत्याव्रता
Satyen	सत्येन
Satyendra	सत्येन्द्र
Saubal	सौबल
Saubhadra	सुभद्रा
Saudeep	सौदीप
Saumit	सौमित
Saumitr	सौमित्र
Saumitra	सौमित्रा
Saunak	सौनक
Saurabh	सौरभ
Saurav	सौरव
Saurjyesh	सौरज्येश
Sava	सवा
Savanth	सवंत
Savar	सवार
Savir	साविर
Savit	सवित
Savitendra	सवितेंद्र
Savya	साव्य
Savya-sachi	साव्य-साची
Sawan	सावन
Sayam	सयम
Sayed	सयेद
Sayeshan	सयेशन
Sayf Udeen	सेफुदीन
Sayid	सईद
Seemanta	सीमान्ता
Sekhar	शेखर
Selvakumaran	सेल्वाकुमारन
Selvan	सेल्वन
Sena	सेना
Senajit	सेनाजित
Sendhil	सेंधिल
SendhilNathan	सेंधिल नाथन
Sengannan	सेंगंनान
Senmal	सेनमल
Senthamarai	सेंथमरई
Senthil	सेंथिल
Seshadri	सेशादरी
Setu	सेतु
Seva	सेवा
Sevak	सेवक
Shaady	शादी
Shabar	शबर
Shabir	शबीर
Shachin	शचीन
Shadab	शादाब
Shafeeq	शफीक
Shagun	शगुन
Shahalad	शहलाद
Shaheen	शाहीन
Shahid	शाहिद
Shail	शैल
Shaildhar	शैलधर
Shailen	शैलेन
Shailendra	शैलेन्द्र
Shailesh	शैलेश
Shaistakhan	शैस्ताखान
Shakib	शकीब
Shaktidhar	शक्तिधर
Shakuni	शकुनी
Shakunt	शाकुंत
Shakyasinha	शक्यासिंह
Shalabh	शलभ
Shalang	शालंग
Shaligram	शालिग्राम
Shalik	शालिक
Shalin	शालीन
Shalina	शालिना
Shalya	शल्य
Shamak	शामक
Shamakarn	शमाकर्ण
Shambhu	शंभू
Shameek	शमीक
Shami	शमी
Shamik	शमिक
Shamindra	शमिन्द्र
Shams	शम्स
Shamshad	शमशु
Shamshu	शमशु
Shan	शान
Shanay	शानए
Shandar	शानदार
Shandilya	शान्दिल्य
Shankar	शंकर
Shankarshan	शंकर्षण
Shankdhar	शंकधर
Shankh	शंख
Shankha	शंखा
Shankhapani	शंखापनी
Shankhi	शंखी
Shankhin	शंखिन
Shankir	शंकिर
Shanmukha	शन्मुखा
Shansa	शान्सा
Shant	शांत
Shantan	शांतन
Shantanav	शंतानव
Shantanu	शंतानु
Shantashil	शंतषील
Shantidev	शांतिदेव
Shantimay	शांतिमय
Shantinath	शांतिनाथ
Shantiprakash	शांतिप्रकाश
Shantipriya	शांतिप्रिया
Shanyu	शान्यु
Shaquita	शाकुइता
Sharad	शरद
Sharadchandra	शरदचंद्र
Sharadendu	शरादेंदु
Sharadindu	शरदींदु
Sharan	शरण
Sharang	शारंग
Sharat	शरत
Sharav	शारव
Shardul	शार्दुल
Shareef	शरीफ
Shareeq	शरीक
Shari	शरी
Shariq	शरीक़
Sharu	शरू
Sharvarish	शर्वरिश
Shashank	शशांक
Shashanka	शशांका
Shashi	शषी
Shashibhushan	शशीभूषण
Shashidhar	शशिधर
Shashikant	शशिकांत
Shashikar	शशिकर
Shashikiran	शशिकिरण
Shashimohan	शशिमोहन
Shashin	शाशिन
Shashipushpa	शशिपुश्पा
Shashish	शाशिश
Shashishekhar	शशिषेखर
Shashvata	शाश्वत
Shashwat	शाश्वत
Shatadru	शताद्रु
Shataneek	शतानीक
Shatayu	शतायु
Shatjit	शतजित
Shat-manyu	शत-मन्यु
Shat-padm	शत-पद्म
Shatrughan	शत्रुघ्न
Shatrughna	शत्रुघ्न
Shatrujit	शत्रुजीत
Shatrunjay	शत्रुन्जय
Shattesh	शत्तेश
Shauchin	शौचिन
Shaukat	शौकत
Shauna	शौना
Shaunak	शौनक
Shaurav	शौरव
Shauri	शौरी
Shaurya	शौर्य
Shay	शय
Shaylan	शयलन
Sheehan	शीहन
Sheetal	शीतल
Sheil	शेइल
Shekhar	शेखर
Shesanand	शेसानंद
Shesh	शेष
Sheshdhar	शेशधर
Shevantilal	शेवन्तीलाल
Shibhya	शिभ्य
Shibil	शिबिल
Shighra	शीघ्र
Shihab	शिहब
Shikha	शिखा
Shikhandin	शिखान्दीन
Shikhar	शिखर
Shilang	शिलांग
Shilish	शिलिश
Shimah	शिमाह
Shineyu	शिनेयु
Shinjan	शिंजन
Shipirist	शिपीरिस्त
Shirdi Prasad	शिरडी प्रसाद
Shirish	शिरश
Shirom	शिरोम
Shiromani	शिरोमणि
Shirshirchandra	शिर्शिरचंद्र
Shishir	शिशिर
Shishirchandra	शिशिर्चंद्र
Shishirkumar	शिशिरकुमार
Shishul	शिशुल
Shishupal	शिशुपाल
Shitikanth	शितिकंथ
Shitiz	शितिज़
Shiv	शिव
Shivadev	शिवदेव
Shivam	शिवम्
Shivanand	शिवानन्द
Shivanath	शिवनाथ
Shivank	शिवांक
Shivansh	शिवांश
Shivas	शिवास
Shivasunu	शिवासुनु
Shiven	शिवेन
Shivendra	शिवेन्द्र
Shivendu	शिवेंदु
Shivesh	शिवेश
Shiveshvar	शिवेश्वर
Shivkumar	शिवकुमार
Shivlal	शिवलाल
Shivraj	शिवराज
Shivram	शिवराम
Shivshankar	शिवशंकर
Shivshekhar	शिवशेखर
Shlesh	श्लेश
Shobhan	शोभन
Shoor	शूर
Shoora	शूरा
Shoorsen	शूरसेन
Shoubhit	शौभित
Shraunak	श्रौनक
Shravan	श्रवण
Shravana	श्रवण
Shravankumar	श्रवणकुमार
Shray	श्रय
Shreedhar	श्रीधर
Shreeharsh	श्रीहर्ष
Shreekant	श्रीकांत
Shreekrishna	श्रीकृष्ण
Shreeman	श्रीमान
Shreepriya	श्रीप्रिया
Shreepushp	श्रीपुष्प
Shreerang	श्रीरंग
Shreesh	श्रीश
Shreevallabh	श्रीवल्लभ
Shrenik	श्रेनिक
Shreshta	श्रेष्ता
Shresth	श्रेष्ठ
Shresthi	श्रेस्ठी
Shrey	श्रेय
Shreyank	श्रेयांक
Shreyansh	श्रेयांश
Shreyas	श्रेयस
Shreyovardhana	श्रेयोवर्धना
Shrida	श्रीदा
Shridhar	श्रीधर
Shrigopal	श्रीगोपाल
Shrihan	श्रीहन
Shrihari	श्रिहरी
Shrikant	श्रीकांत
Shrikanta	श्रीकांता
Shrikar	श्रिकार
Shrikeshav	श्रीकेशव
Shrikrishna	श्रीकृष्ण
Shrikumar	श्रीकुमार
Shrimat	श्रीमत
Shrimate	श्रीमते
Shrimohan	श्रीमोहन
Shrinand	श्रीनंद
Shrinath	श्रीनाथ
Shringesh	श्रिंगेश
Shriniketan	श्रीनिकेतन
Shrinivas	श्रीनिवास
Shripad	श्रिपद
Shripadma	श्रीपद्मा
Shripal	श्रिपल
Shripati	श्रीपति
Shriram	श्रीराम
Shriranga	श्रीरंगा
Shriranjan	श्रीरंजन
Shrish	श्रीश
Shrisha	श्रीषा
Shrivarah	श्रीवरह
Shrivardhan	श्रीवर्धन
Shrivas	श्रीवास
Shrivatsa	श्रीवत्सा
Shrivatsav	श्रीवत्सव
Shriyadita	श्रीयादिता
Shriyans	श्रीयांस
Shrot	श्रोत
Shrutakeerti	श्रुतकीर्ति
Shrutik	श्रुतिक
Shubendra	शुबेन्द्र
Shubh	शुभ
Shubha	शुभा
Shubhaksh	शुभाक्ष
Shubhan	शुभन
Shubhang	शुभंग
Shubhankar	शुभंकर
Shubhashis	शुभाषिस
Shubhasunad	शुभसुनद
Shubhay	शुभाय
Shubhendu	शुभेंदु
Shubhojit	शुभोजित
Shubhranshu	शुभ्रांशु
Shubhratho	शुभ्रथो
Shuddhashil	शुद्धशील
Shuk	शुक
Shukra	शुक्र
Shuktij	शुकतिज
Shulabh	शुलभ
Shulandhar	शुलंधर
Shulin	शुलिन
Shuna	शुना
Shushil	शुशील
Shvant	श्वंत
Shvetambar	श्वेताम्बर
Shvetang	श्वेतांग
Shvetank	श्वेतांक
Shvetanshu	श्वेतान्शु
Shvetavah	श्वेतावः
Shwetambar	श्वेताम्बर
Shwetanshu	श्वेतान्शु
Shwetbhanu	श्वेत्भानु
Shyam	श्याम
Shyamak	श्यामक
Shyamal	श्यामल
Shyamantak	श्यामन्तक
Shyamsundar	श्यामसुंदर
Shyamsunder	श्यामसुंदर
Siamak	सिअमाक
Sidak	सिदक
Siddak	सिद्दक
Siddha	सिद्धा
Siddhadev	सिद्धादेव
Siddhanath	सिद्धनाथ
Siddhanta	सिद्धांता
Siddharth	सिद्धार्थ
Siddhartha	सिद्धार्ता
Siddhesh	सिद्धेश
Siddheshwar	सिद्धेश्वर
Siddhraj	सिद्धराज
Siddid	सिद्दिद
Sikandar	सिकंदर
Sindhunath	सिन्धुनाथ
Singaravelan	सिंगारवेलन
Sinha	सिन्हा
Sinhag	सिन्हाग
Sinhvahan	सिन्हवाहन
Siraj	सिराज
Siraj	सिराज
Sitakanta	सिताकांता
Sitanshu	सितांशू
Sitaram	सीताराम
Sitikantha	सितिकान्था
Sivakumaran	सिवा कुमारन
Sivanta	सिवांता
Skand	स्कन्द
Smarajit	स्मरजीत
Smaran	स्मरण
Smiren	स्मिरेन
Smritiman	स्मृतिमान
Smyan	ष्मयन
Sneagen	सनागें
Snehakant	स्नेहकांत
Snehal	स्नेहल
Snehanshn	स्नेहनशन
Snehil	स्नेहिल
Snehin	स्नेहिं
Sohail	सोहैल
Soham	सोहम
Sohan	सोहन
Sohil	सोहिल
Sokanathan	सोकनाथान
Som	सोम
Somadev	सोमदेव
Somali	सोमाली
Soman	सोमन
Somansh	सोमांश
Somanshu	सोमान्शु
Somashekhar	सोमाशेखर
Somasindhu	सोमासिंधू
Somendra	सोमेंद्र
Somesh	सोमेश
Someshwar	सोमेश्वर
Somkar	सोमकर
Somnath	सोमनाथ
Somprakash	सोमप्रकाश
Sonit	सोनित
Sopan	सोपान
Soumava	सौमावा
Soumil	सौमील
Soumyakanti	सौम्यकान्ति
Sourabh	सौरभ
Souren	सौरेन
Sourish	सौरिश
Sparsh	स्पर्श
Sragvibhushan	स्राग्विभुशन
Sreevalsan	श्रीवल्सन
Sriashwin	श्रीअश्विन
Sridatta	श्रीदत्ता
Sridhar	श्रीधर
Srihith	श्रीहित
Srijan	सृजन
Srijesh	श्रीजेश
Srikant	श्रीकांत
Srikar	श्रीकर
Srinesh	श्रीनेश
Srinish	श्रीनिश
Srinivas	श्रीनिवास
Sriram	श्रीराम
Srivant	श्रीवंत
Srivar	श्रीवर
Srivatsav	श्रीवत्सव
Stavya	स्ताव्य
Sthavir	स्थाविर
Sthir	स्थिर
Stotri	स्तोत्री
Sual	सुअल
Subahu	सुबाहु
Subal	सुबल
Subali	सुबली
Subandhu	सुबंधु
Subash	सुबाश
Subbarao	सुब्बाराव
Subeer	सुबीर
Subhadr	सुभद्र
Subhag	सुभग
Subhan	सुभन
Subhang	सुभंग
Subhas	सुभास
Subhash	सुभाष
Subhendu	सुभेंदु
Subhradip	सुभ्रदिप
Subhy	सुभ्य
Subinay	सुबिनय
Subodh	सुबोध
Subrahmanya	सुब्रहमान्य
Subramani	सुब्रमणि
Subrata	सुब्रता
Subratah	सुब्रतः
Suchendra	सुचेन्द्र
Suchet	सुचेत
Suchin	सुचिन
Suchir	सुचिर
Suchit	सूचित
Sudalai	सुदलाई
Sudama	सुदामा
Sudarshan	सुदर्शन
Suday	सुदय
Sudeep	सुदीप
Sudesh	सुदेश
Sudesha	सुदेशा
Sudev	सुदेव
Sudeva	सुदेव
Sudhakar	सुधाकर
Sudhamay	सुधामय
Sudhan	सुधान
Sudhang	सुधांग
Sudhanshu	सुधांशु
Sudhanssu	सुधानससु
Sudhanvan	सुधांवन
Sudhendra	सुधेन्द्र
Sudhi	सूधी
Sudhindra	सुधिन्द्र
Sudhir	सुधीर
Sudhish	सुधीश
Sudhit	सुधित
Sudhith	सुधीत
Sudin	सुदिन
Sudip	सुदीप
Sudir	सुदिर
Sugandh	सुगंध
Sugata	सुगता
Sughosh	सुघोश
Sugreev	सूग्रीव
Sugriva	सुग्रिवा
Suhail	सुहैल
Suhas	सुहास
Suhayb	सुहय्ब
Suhrid	सुह्रिद
Suhrit	सुहृत
Suhruda	सुह्रुदा
Sujal	सुजल
Sujan	सूजन
Sujash	सुज़ाश
Sujat	सुजत
Sujay	सूजाय
Sujendran	सुजेंद्रन
Sujetu	सुजेतु
Sujit	सुजीत
Suka	सुका
Sukant	सुकंत
Sukant	सुकांत
Sukarma	सुकर्म
Sukarman	सुकर्मन
Sukesh	सुकेश
Suketu	सुकेतु
Sukhajat	सुखाजत
Sukhakar	सुखाकर
Sukhamay	सूख़मय
Sukhashakt	सुखाशाक्त
Sukhdev	सुखदेव
Sukhesh	सुखेश
Sukhwant	सुखवंत
Sukhwinder	सुखविंदर
Sukrant	सुक्रांत
Sukrit	सुक्रित
Sukumar	सुकुमार
Sukumara	सुकुमार
Sukumaran	सुकुमारन
Sulabh	सुलभ
Sulalit	सुललीत
Sulayman	सुलेमान
Sulek	सुलेक
Sulekh	सुलेख
Sulochan	सुलोचन
Sultan	सुलतान
Sumadhur	सुमधुर
Suman	सुमन
Sumangal	सुमंगल
Sumant	सुमंत
Sumanta	सुमंता
Sumantra	सुमंत्र
Sumantu	सुमान्तु
Sumanyu	सुमंयु
Sumatinath	सुमतिनाथ
Sumay	सुमय
Sumed	सुमेद
Sumedh	सुमेध
Sumeer	सुमीर
Sumeet	सुमीत
Sumeru	सुमेरु
Sumesh	सुमेश
Sumiran	सुमिरन
Sumit	सुमीत
Sumitr	सुमित्र
Sumitra	सुमीत्रा
Sumitranandan	सुमित्रानंदन
Sumukh	सुमुख
Sunam	सुनाम
Sunand	सुनंद
Sunanda	सुनंदा
Sunandan	सुनंदन
Sunar	सुनार
Sunashi	सुनाशी
Sunasi	सुनासी
Sunay	सुनय
Sunchit	सुन्चित
Sundar	सुंदर
Sundara	सुन्दरा
Sundaravel	सुंदरवेल
Sunder	सुंदर
Suneet	सुनीत
Sunil	सुनील
Sunirmal	सुनिर्मल
Sunjeev	सुंजीव
Suoud	सुऔद्
Suparn	सुपर्ण
Suparna	सुपर्णा
Supash	सुपाश
Suprabhat	सुप्रभात
Suprakash	सुप्रकाश
Suprasanna	सुप्रसंना
Supratik	सुप्रतिक
Supratim	सुप्रतिम
Supreet	सुप्रीत
Suprit	सुप्रित
Sur	सुर
Suradhish	सुराधिष
Suradip	सुरादिप
Suragan	सुरगन
Suraj	सूरज
Surajit	सुरजीत
Surajiv	सुराजीव
Suram	सुरम
Suran	सुरण
Suranjan	सुरंज़न
Surarihan	सुरारीहन
Suras	सुरस
Surbhup	सुर्भुप
Surdas	सूरदास
Surdeep	सुरदीप
Suren	सुरेन
Surendra	सुरेन्द्र
Suresh	सुरेश
Sureshwar	सुरेश्वर
Suri	सूरी
Surjeet	सुरजीत
Surnath	सुरनाथ
Surshri	सुरश्री
Surup	सुरूप
Surush	सुरुष
Surya	सूर्या
Suryabhan	सूर्याभान
Suryadev	सूर्यदेव
Suryakant	सूर्यकांत
Suryakanta	सुर्यकांता
Suryansh	सुर्यांश
Suryanshu	सुर्यान्शु
Suryaprakash	सुर्यप्रकाश
Suryashankar	सुर्यशंकर
Suryesh	सुर्येश
Susadh	सुसध
Susan	सूसन
Susen	सुसेन
Sushant	सुशांत
Sushanta	सुशांता
Sushen	सुषेन
Susher	सुशेर
Sushil	सुशील
Sushim	सुशिम
Sushobhan	सुशोभन
Sushrut	सुश्रुत
Sushruta	सुश्रुता
Susil	सुसील
Sutantu	सुतान्तु
Sutara	सूत्र
Sutej	सुतेज
Sutejas	सुतेजस
Sutirth	सुतिर्थ
Sutosh	सुतोश
Sutoya	सुतोया
Suvan	सुवन
Suvarn	सुवर्ण
Suvas	सुवास
Suvel	सुवेल
Suvidh	सुविध
Suvimal	सूवीमल
Suvir	सुविर
Suvrata	सुव्रता
Suyamun	सुयामुं
Suyash	सुयाश
Suyati	सुयती
Svamin	स्वमं
Svaminath	स्वामिनाथ
Svang	स्वांग
Svanik	स्वानिक
Svar	स्वर
Svaraj	स्वराज
Svarg	स्वर्ग
Svarna	स्वर्ण
Svarpati	स्वरपति
Svayambhu	स्वयंभू
Svayambhut	स्वयमभुत
Swadhin	स्वाधीन
Swagat	स्वागत
Swajith	स्वजिथ
Swami	स्वामी
Swaminath	स्वामीनत
Swapan	स्वपन
Swapnesh	स्वप्नेश
Swapnil	स्वप्निल
Swaraj	स्वराज
Swarit	स्वरित
Swarnapurishwara	स्वर्नापुरिश्वारा
Swarup	स्वरूप
Swastik	स्वस्तिक
Swatantar	स्वतांतर
Swayambhu	स्वयम्भू
Swetaketu	स्वेतकेतु
Swethan	स्वेथान
Syamantak	स्यमनतक
Syon	स्योन
Syum	स्युम
Saabira	साबिरा
Saaliha	सालिहा
Saalima	सालिमा
Saamiya	सामिया
Saba	सबा
Sabeena	सबीना
Sabita	सबिता
Sabrang	सबरंग
Sabri	सबरी
Sabria	सब्रिया
Sachi	साची
Sachika	साचिका
Sachita	सचिता
Sadabhuja	सदभुजा
Sadaf	सदाफ़
Sadgati	सदगति
Sadguna	सदगुना
Sadhan	साधन
Sadhana	साधना
Sadhika	साधिका
Sadhna	साधना
Sadhri	साध्री
Sadhvi	साध्वी
Sadhya	साध्या
Sadia	सदिया
Sadiqua	सदिकुआ
Saee	साई
Saeeda	साइदा
Saesha	सैषा
Safa	सफा
Safia	सफिया
Safiya	सफिया
Sagari	सागरी
Sagarika	सागरिका
Saguna	सगुना
Sahana	सहाना
Sahasra	सहसरा
Saheli	सहेली
Sahiba	साहिबा
Sahila	सहिला
Sahima	सहिमा
Sahitha	सहिता
Sahitya	साहित्य
Sahla	सहला
Sahna	सहना
Sahoj	सहोज
Sai	साई
SaiJayani	सैजयानी
Sajala	सजला
Sajani	सजनी
Sajili	सजीली
Sajni	सजनी
Sakeena	सकीना
Saketha	साकेथा
Sakhi	सखी
Sakina	सकीना
Sakshi	साक्षी
Saleema	सलीमा
Salena	सालेना
Salila	सलिला
Salima	सलीमा
Salma	सल्मा
Saloni	सलोनी
Salwa	सलवा
Samaah	समाः
Samali	सामली
Samata	समता
Sameeha	समीहा
Sameena	समीना
Sameera	समीरा
Samhita	संहिता
Samidha	समिधा
Samika	समिका
Samiksha	समीक्षा
Samit	समित
Samita	समिता
Samiya	समिया
Sammathi	सम्मति
Sampada	संपदा
Sampatti	संपत्ति
Sampriti	समप्रिती
Samreen	साम्रीन
Samriddhi	समृद्धि
Samrithi	सम्रिथि
Samrta	सम्रता
Samvidha	संविधा
Sana	साना
Sanah	सनाह
Sananda	सानंदा
Sanatani	सनातनी
Sanchali	संचाली
Sanchaya	संचाया
Sanchita	संचिता
Sandhaya	संधाया
Sandhra	संधरा
Sandhya	संध्या
Sanemi	सनेमी
Sangita	संगीता
Sangya	संज्ञा
Sani	सानी
Sanika	सनिका
Sanithi	सनीति
Saniya	सानिया
Sanjana	संजना
Sanjaya	संजया
Sanjh	सांझ
Sanjita	संजिता
Sanjivani	संजीवनी
Sanjna	संजना
Sanjukta	संजुकता
Sanjula	संजुला
Sanjushree	संजुश्री
Sankari	संकरी
Sankul	संकुल
Sannidhi	सन्निधि
Sanoja	सनोजा
Sansita	संसिता
Sanskriti	संस्कृति
Santati	संतति
Santawana	संतवाना
Santayani	संतयानी
Santoshi	संतोषी
Santushti	संतुष्टि
Sanvali	साँवली
Sanvi	सान्वी
Sanwari	साँवरी
Sanyakta	संयक्ता
Sanyogita	संयोगिता
Sanyukta	संयुक्ता
Saparna	सपर्णा
Saphala	सफ़ला
Sapna	सपना
Sara	सारा
Sarada	सारदा
Sarakshi	साराक्षी
Sarala	सरला
Sarama	सरामा
Sarani	सारणी
Saranya	सारान्य
Sarasa	सरसा
Sarasi	सारसी
Sarasvati	सरस्वती
Saraswati	सरस्वती
Saravati	सारावती
Sarayu	सरयू
Sarbani	सर्बानी
Sargini	सर्गिनी
Sarika	सारिका
Sarisha	सरिशा
Sarit	सरित
Sarita	सरिता
Sariyah	सरियाह
Sarjana	सर्जना
Sarjena	सर्जेना
Sarla	सरला
Saroj	सरोज
Saroja	सरोज़ा
Sarojini	सरोजिनी
Saruchi	सरुची
Sarupa	सरूपा
Saruprani	सरुप्रानी
Sarvani	सरवानी
Sarvari	सरवारी
Sarvika	सर्विका
Saryu	सरयू
Sashi	सशि
Sasmita	सस्मिता
Sasthi	सस्ती
Satha	सथा
Sati	सती
Sattviki	सात्त्विकी
Satvari	सतवारी
Satvi	सात्वी
Satvika	सत्विका
Satviki	सत्विकी
Satya	सत्या
Satyarupa	सत्यारूपा
Satyavati	सत्यवती
Saudamini	सौदामिनी
Saujanya	सौजन्या
Saumya	सौम्या
Saumyi	सौम्यी
Saundarya	सौंदर्य
Saura	सौर
Savarna	सवर्ण
Savidharani	सविधारानी
Savita	सविता
Savitashri	सविताश्री
Savitha	साविथा
Savitri	सावित्री
Sawda	सवदा
Sawini	सवीनी
Sawsan	सव्सन
Sayali	सयाली
Sayeeda	सईदा
Sayona	सयोना
Sayuri	सयुरी
Sazia	सजिया
Seema	सीमा
Seemanti	सीमांति
Seemantini	सीमान्तीनी
Seerat	सीरत
Sejal	सेज़ल
Selma	सेल्मा
Semanti	सेमंती
Serena	सेरेना
Sesha	सेषा
Setu	सेतु
Seva	सेवा
Sevati	सेवती
Sevita	सेविता
Shaadiya	शादिया
Shabab	शबाब
Shabalini	शबालिनी
Shabana	शबाना
Shabari	शबरी
Shabnam	शबनम
Shabnum	शबनम
Shachi	शाची
Shadan	शदन
Shagufta	शागुफ़्ता
Shagun	शगुन
Shaheena	शाहीना
Shahnaz	शहनाज
Shaila	शैला
Shailaja	शैलजा
Shailasha	शैलषा
Shaili	शैली
Shaivi	शैवि
Shakambari	शकाम्बरी
Shakeel	शकील
Shakeela	शकीला
Shakini	शकिनी
Shakti	शक्ति
Shakuntala	शाकुंतला
Shalaka	शलाका
Shalalu	शलालु
Shalika	शालिका
Shalin	शालीन
Shalini	शालिनी
Shalmali	शलमाली
Shama	शमा
Shambari	शाम्बरी
Shambhavi	शम्भावी
Shambhukanta	शम्भुकांता
Shameena	शमीना
Shamim	शमीम
Shamita	शमिता
Shampa	शंपा
Shankari	शंकरी
Shankhamala	शंखमाला
Shansa	शांसा
Shanta	शांता
Shantala	शंताला
Shanthini	शांथिनी
Shanti	शांति
Sha'Quarria	शाकुँर्रिया
Sharada	शारदा
Sharadini	शारदिनी
Sharani	शारानी
Sharanya	शरान्य
Sharaya	शरया
Sharda	शारदा
Shareefa	शरीफा
Shari	शारी
Sharika	शारिका
Sharini	शारिनी
Sharmadha	शर्मधा
Sharmila	शर्मिला
Sharmistha	शर्मीस्था
Sharvani	शरवानी
Sharvari	शरवरी
Shasha	शशा
Shashi	शशि
Shashibala	शशिबाला
Shashikala	शशिकला
Shashini	शशिनी
Shashiprabha	शशिप्रभा
Shashirekha	शशिरेखा
Shaswati	शास्वती
Shatakshi	शताक्षी
Shatarupa	शतरूपा
Shatha	सतह
Shaveena	शावीना
Shayna	शायना
Shazia	शाजिया
Sheeba	शीबा
Sheela	शीला
Sheen	शीन
Sheetal	शीतल
Shefali	शेफाली
Shefalika	शेफालिका
Shejali	शेज़ाली
Shekhar	शेखर
Sheoli	शेओली
Shevalini	शेवालिनी
Shevanti	शेवंती
Shibani	शिबानी
Shichi	शिची
Shikha	शिखा
Shila	शिला
Shilavati	शिलावती
Shilavatia	शिलावतिया
Shilna	शिलना
Shilpa	शिल्पा
Shilpita	शिल्पिता
Shina	शीना
Shinat	शिनत
Shinjini	शिन्जिनी
Shipra	शिप्रा
Shirin	शिरीन
Shirina	शिरिना
Shishirkana	शिशिरकना
Shiuli	शिली
Shivakanta	शिवकांता
Shivali	शिवाली
Shivangi	शिवांगी
Shivani	शिवानी
Shivanjali	शिवांजलि
Shivanne	शिवाँने
Shivanshi	शिवान्शी
Shivapriya	शिवप्रिया
Shivasundari	शिवासुंदरी
Shivi	शिवी
Shivika	शिविका
Shivli	शिवली
Shlesha	श्लेषा
Shloka	श्लोका
Shobha	शोभा
Shobhana	शोभना
Shobhita	शोभीता
Shobhna	शोभना
Shomili	शोमिली
Shoni	शोनी
Shonima	शोनिमा
Shorashi	शोरशि
Shraddha	श्रद्धा
Shradhdha	श्रध्दा
Shrankhla	श्रंखला
Shravana	श्रवना
Shravani	श्रवनी
Shravanthi	श्रवंथी
Shravanti	श्रवंती
Shravasti	श्रावस्ती
Shraya	श्राया
Shree	श्री
Shreela	श्रीला
Shreema	श्रीमा
Shreemayi	श्रीमाई
Shreeparna	श्रीपर्णा
Shreeprada	श्रीप्रदा
Shreeya	श्रीया
Shrejal	श्रेजल
Shrena	श्रेना
Shresta	श्रेस्ता
Shresth	श्रेष्ठ
Shrestha	श्रेष्ठा
Shresthi	श्रेस्थी
Shreya	श्रेया
Shreyashi	श्रेयशी
Shri	श्री
Shridevi	श्रीदेवी
Shridula	श्रीदुला
Shrigauri	श्रीगौरी
Shrigeeta	श्रीगीता
Shrijani	श्रीजनी
Shrika	श्रीका
Shrikala	श्रीकला
Shrikama	श्रीकामा
Shrikirti	श्रीकिर्ती
Shrikumari	श्रीकुमारी
Shrila	श्रिला
Shrilata	श्रीलता
Shrilaxmi	श्रीलक्ष्मी
Shrilekha	श्रीलेखा
Shrimati	श्रीमती
Shrimayi	श्रीमायी
Shrina	श्रीना
Shrinitha	श्रीनिथा
Shristi	श्रीस्ती
Shrivalli	श्रीवाल्ली
Shrividya	श्रीविद्या
Shriya	श्रिया
Shriyadita	श्रीयादिता
Shrujana	श्रुजना
Shrujeshwari	श्रुजेश्वरी
Shruta	श्रुता
Shrutaly	श्रुताली
Shruthi	श्रुथि
Shruthika	श्रुथिका
Shruti	श्रुति
Shrutika	श्रुतिका
Shrutuja	श्रुतुजा
Shubha	शुभा
Shubhada	शुभदा
Shubhangi	शुभंगी
Shubhra	शुभ्रा
Shuchi	शुचि
Shuchismita	शुचीस्मिता
Shuchita	शुचिता
Shuddhi	शुद्धि
Shukla	शुक्ला
Shukti	शुक्ती
Shulini	शुलिनी
Shulka	शूलका
Shushma	शुष्मा
Shutradevi	शुत्रदेवी
Shveni	श्वेनी
Shveta	श्वेता
Shweta	श्वेता
Shyama	श्यामा
Shyamal	श्यामल
Shyamala	श्यामाला
Shyamali	श्यामली
Shyamalika	श्यामलिका
Shyamalima	श्यामालिमा
Shyamangi	श्यामंगी
Shyamari	श्यामरी
Shyamasri	श्यामाश्री
Shyamini	श्यामिनी
Shyamlata	श्यामलता
Shyla	श्यला
Sibani	सिबानी
Siddhama	सिद्धामा
Siddhangana	सिद्धंगाना
Siddhani	सिद्धानी
Siddheshwari	सिद्धेश्वरी
Siddhi	सिद्धि
Siddhiksha	सिद्धिक्षा
Siddhima	सिद्धिमा
Sihaam	सिहाम
Sikata	सिकता
Sikta	सिक्ता
Simbala	सिम्बाला
Simran	सिमरन
Sindhu	सिंधु
Sindhuja	सिन्धुजा
Sinhayana	सिंहयाना
Sinjini	सिंजिनी
Sinsapa	सिंसपा
Sirisha	सिरिषा
Sita	सीता
Sitara	सितारा
Sitesh	सीतेश
Sivanandhini	सिवानंधिनी
Sivaneswary	सिवानेस्वरी
SivaSankari	सिवासंकरी
Sivasathi	सिवासथी
Siya	सिया
Siyona	सियोना
Skanda	स्कंदा
Skandajit	स्कंदाजित
Smera	स्मेरा
Smita	स्मिता
Smrita	सिमृत
Smriti	स्मृति
Smruti	स्मृति
Sneh	स्नेह
Sneha	स्नेहा
Snehal	स्नेहल
Snehalata	स्नेहलता
Snehelata	स्नेहेलता
Snehi	स्नेही
Snigda	स्निग्दा
Snigdha	स्निग्धा
Sohalia	सोहलिया
Sohana	सोहना
Sohni	सोहनी
Soma	सोमा
Somalakshmi	सोमलक्ष्मी
Somansh	सोमांश
Somatra	सोमात्रा
Somila	सोमिला
Sona	सोना
Sonakshi	सोनाक्षी
Sonal	सोनल
Sonali	सोनाली
Sonam	सोनम
Soneera	सोनीरा
Sonia	सोनिया
Sonika	सोनिका
Soonera	सूनेरा
Soorat	सूरत
Sosamma	सोसम्मा
Sougandika	सौगंदिका
Soukhya	सौख्य
Soumya	सौम्या
Sourabhi	सौरभी
Sowjanya	सोवजन्य
Sowmya	सोवम्या
Sphatika	स्फ़टिका
Spoorthy	स्पूर्ति
Sragvi	स्रगवि
Sravanti	स्रवंती
Sreeja	स्रीजा
Sreejata	स्रीजता
Sreya	श्रेया
Sridatri	श्रीदात्री
Sridevi	श्रीदेवी
Srihitha	सृहिथा
Srikanya	सृकान्य
Srinika	सृनिका
Srinithi	सृनिथी
Sripada	श्रीपदा
Srisha	श्रीषा
Sristi	सृस्ती
Sriya	श्रिया
Stavita	स्तविता
Striratna	स्त्रिरत्ना
Stuti	स्तुति
Subarna	सुबरना
Subhadra	सुभद्रा
Subhaga	सुभगा
Subhagya	सुभाग्य
Subhashini	सुभाषिनी
Subhasini	सुभासिनी
Subhi	सुभि
Subhiksha	सुभिक्षा
Subhuja	सूभूजा
Subodhini	सुबोधिनी
Subrata	सुब्रता
Suchandra	सूचंद्रा
Sucharita	सुचरिता
Sucheta	सूचेता
Suchhaya	सुछाया
Suchi	सूची
Suchira	सुचिरा
Suchismita	सुचिस्मिता
Suchita	सूचिता
Suchitra	सूचित्रा
Sudakshima	सूदक्षीमा
Sudarshana	सुदर्शना
Sudarshini	सुदार्शिनी
Sudeepa	सुदीपा
Sudeepta	सुदीप्ता
Sudena	सुदेना
Sudeshna	सुदेशना
Sudevi	सुदेवी
Sudha	सुधा
Sudhamayi	सुधामयी
Sudhira	सुधिरा
Sudhithi	सुधीति
Sudiksha	सुदिक्षा
Sudipta	सुदिप्ता
Sudipti	सुदिप्ती
Suditi	सुदिती
Sugandha	सुगंधा
Suganya	सुगान्य
Sugathri	सुगाथ्री
Sugauri	सुगौरी
Sugita	सुगीता
Sugouri	सुग़ौरी
Suha	सुहा
Suhag	सुहाग
Suhaila	सुहैला
Suhair	सुहैर
Suhasini	सुहासिनी
Suhavi	सुहावी
Suhayla	सुहय्ला
Suhayma	सुहाय्मा
Suhela	सुहेला
Suhina	सुहीना
Suhitha	सुहीता
Suhrita	सुह्रिता
Sujala	सूजला
Sujata	सुजाता
Sujaya	सूजाया
Sujitha	सुजिथा
Sukanya	सुकन्या
Sukeshi	सुकेशी
Sukhada	सुखदा
Sukhmani	सुखमनी
Sukriti	सुकृति
Sukruti	सुकृति
Suksha	सुक्षा
Sukshma	सुक्ष्म
Suksma	सुक्स्मा
Sukthi	सुक्ति
Sukumari	सुकुमारी
Sukushi	सुकुशी
Sulabha	सुलभा
Sulaksha	सुलक्षा
Sulakshana	सुलक्षणा
Sulakshmi	सुलक्ष्मी
Sulalita	सुललिता
Sulbha	सुलभा
Sulekh	सुलेख
Sulekha	सुलेखा
Suloch	सुलोच
Sulochana	सुलोचना
Sultana	सुल्ताना
Suma	सुमा
Sumaira	सुमैरा
Sumaiyaa	सुमैया
Sumana	सुमना
Sumangli	सुमंगली
Sumanolata	सुमानोलता
Sumati	सुमति
Sumavali	सुमावली
Sumedha	सुमेधा
Sumi	सुमि
Sumita	सुमीता
Sumitha	सुमिथा
Sumitra	सुमीत्रा
Sumona	सुमोना
Sumukhi	सुमुखी
Sunaina	सुनैना
Sunamya	सुनम्या
Sunanda	सुनंदा
Sunandini	सुनंदिनी
Sunandita	सुनंदिता
Sunaya	सुनया
Sunayana	सुनयना
Sunayani	सुनयनी
Sunayna	सुनयना
Sundari	सुंदरी
Sundha	सुंधा
Sundhuja	सुन्धुजा
Sunetra	सुनेत्रा
Sunila	सुनीला
Suniska	सुनिस्का
Sunita	सुनीता
Suniti	सुनीति
Suparna	सुपर्णा
Suprabha	सुप्रभा
Suprasanna	सुप्रसंना
Supreetha	सुप्रीथा
Suprema	सुप्रेमा
Suprita	सुप्रिता
Supriti	सुप्रीति
Supriya	सुप्रिया
Supti	सुप्ती
Surabhi	सुरभी
Suraksha	सुरक्षा
Surama	सूरमा
Surangi	सुरंगी
Suranjana	सुरंज़ना
Surasa	सुरसा
Surasti	सुरस्ती
Suravi	सुरावी
Suravinda	सुरविन्दा
Surekha	सुरेखा
Sureshi	सुरेशी
Sureshwari	सुरेश्वरी
Surina	सूरीना
Surotama	सुरोतमा
Suruchi	सुरुचि
Surupa	सुरूपा
Surya	सूर्या
Suryadita	सुर्यदिता
Suryakanti	सुर्यकांति
Suryani	सुर्यानी
Sushama	सुषमा
Sushanti	सुशांति
Sushila	सुशीला
Sushma	सुष्मा
Sushmita	सुष्मिता
Sushobhana	सुशोभना
Susila	सुसीला
Susita	सुसीता
Susmita	सुस्मिता
Susumna	सुसुमना
Sutanuka	सुतानुका
Sutapa	सूतापा
Sutara	सुतारा
Suvali	सुवाली
Suvarna	सुवर्ना
Suvarnaprabha	सुवार्नाप्रभा
Suvarnarekha	सुवर्णरेखा
Suvarnmala	सुवर्णमाला
Suvitha	सुविथा
Suyasha	सुयाषा
Svadhi	स्वधि
Svaha	स्वाहा
Svana	स्वाना
Svara	स्वरा
Svitra	सवित्रा
Swagata	स्वागता
Swaha	स्वाहा
Swapanthi	स्वपंथी
Swapna	स्वप्ना
Swapnali	स्वप्नाली
Swapnasundari	स्वप्नसूंदरी
Swapnika	स्वप्निका
Swara	स्वरा
Swarnalata	स्वर्णलता
Swarnaprabha	स्वर्नप्रभा
Swarnika	स्वर्निका
Swarupa	स्वरूपा
Swasti	स्वस्ती
Swastika	स्वस्तिका
Swati	स्वाती
Sweta	स्वेता
Swetha	स्वेथा
Taahir	ताहिर
Taamir	तामीर
Tabrez	तबरेज़
Taha	तहा
Tahir	ताहिर
Tahoma	तहोमा
Taizeen	ताज़ीन
Taj	ताज
Tajdar	ताजदार
Taksa	तक्सा
Taksha	तक्षा
Takshak	तक्षक
Taksheel	तक्शील
Talaketu	तलाकेतु
Talal	तलाल
Talank	तलंक
Talat	तलत
Talha	ताल्हा
Talib	तालिब
Talin	तालिन
Talish	तलिश
Talleen	तल्लीन
Tamal	तमाल
Tamam	तमाम
Tamas	तमस
Tamila	तमिला
Tamish	तमिश
Tamkinat	ताम्किनत
Tamoghna	तमोघ्ना
Tamonash	तमोनष
Tamra	ताम्र
Tana	ताना
Tanav	तनाव
Tanay	तनय
Tanish	तनिश
Tanishq	तनिश्क
Tanmay	तन्मय
Tanuj	तनुज
Tanul	तनुल
Tanveer	तनवीर
Tapan	तपन
Tapas	तपस
Tapasendra	तपसेन्द्र
Tapasranjan	तपसरंजन
Tapendra	तपेन्द्र
Tapesh	तपेश
Tapomay	तपोमय
Taporaj	तपोराज
Tarachand	ताराचंद
Tarachandra	ताराचंद्र
Taradhish	ताराधिश
Tarak	तारक
Tarakesh	तारकेश
Tarakeshwar	तारकेश्वर
Taraknath	तारकनाथ
Taraksh	ताराक्ष
Taral	तरल
Taran	तरण
Tarang	तरंग
Taranga	तरंगा
Tarani	तरनी
Taranjot	तरंजोत
Tarank	तारंक
Taraprashad	तारा प्रशाद
Tareef	तारीफ
Tarendra	तरेन्द्र
Taresh	तारेश
Tarfah	तराह
Tarik	तारिक
Tariq	तारिक़
Tarit	तरित
Tarosh	तरोश
Tarpan	तर्पण
Tarun	तरुण
Taruntapan	तरुणतपन
Tarusa	तरुसा
Tathagat	तथागत
Tathagata	तथागता
Tatharaj	तथाराज
Tatya	तात्या
Tausiq	तौसिक़
Tautik	तौतिक
Tavish	तविश
Tawfeeq	तव्फीक
Taymullah	तय्मुल्लाह
Tayseer	तय्सीर
Teerth	तीर्थ
Teerthankar	तीर्थंकर
Tegvir	तेगविर
Tej	तेज़
Tejas	तेजस
Tejeshwar	तेजेश्वर
Tejomay	तेजोमय
Thaabit	थाबित
Thakarshi	ठाकरशी
Thakur	ठाकुर
Thaman	थमन
Thangabalu	थान्गबलू
Thangadurai	थान्गदुरै
Thangamani	तंगामनी
Thangarajan	तनगराजन
Thangasami	तंगसामी
Thangavel	तंगवेल
Thaqib	थाकिब
Thashan	थशन
Thavanesh	थावानेश
Thayalan	थयालन
Thayanban	थायांबन
Theeran	थीरण
Thenappan	थेनाप्पन
Thevan	तेवन
Thinakaran	थिनाकरण
Thirugnanam	थिरुग्ननम
Thirumal	तिरूमाल
Thirumalai	तिरूमालाई
Thirumani	तिरुमानि
Thiruvalluvar	तिरूवाल्लूवार
Thooyavan	थूयावन
Thulasitharan	थुलासिथारण
Tijil	तिजिल
Tilak	तिलक
Timin	तिमिन
Timir	तिमिर
Timirbaran	तिमिर्बरन
Timmy	टिम्मी
Timothy	तिमोथी
Tirranand	तीर्रानंद
Tirth	तीर्था
Tirtha	तीर्था
Tirthankar	तीर्थंकर
Tirthayad	तिर्थायाद
Tirumala	तिरुमला
Tirupathi	तिरुपथी
Tisyaketu	तिस्यकेतु
Titir	तितिर
Toshan	तोशण
Toya	तोय
Toyesh	तोयेश
Trailokva	त्रैलोक्वा
Trambak	त्रंबक
Triambak	त्रिंबक
Tribhuvan	त्रिभुवन
Tridev	त्रिदेव
Tridhaman	त्रिधामन
Tridhatri	त्रिधात्री
Tridib	त्रिदिब
Tridiva	त्रिदिवा
Trigun	त्रिगुण
Trigya	त्रिज्या
Trijal	त्रिजल
Trikay	त्रीकाय
Trilochan	त्रिलोचन
Trilok	त्रीलॉक
Trilokanath	त्रिलोकनाथ
Trilokchand	त्रिलोकचंद
Trilokesh	त्रिलोकेश
Triman	त्रिमान
Trimurti	त्रिमूर्ति
Trinabh	त्रिनाभ
Trinath	त्रिनाथ
Trinayan	त्रिनयन
Tripurajit	त्रिपुराजित
Tripurari	त्रिपुरारी
Trisanu	त्रिसनु
Trishanku	त्रिशंकु
Trishar	त्रिषर
Trishul	त्रिशूल
Trishulank	त्रिशुलांक
Trishulin	त्रिशुलिन
Trivikram	त्रिविक्रम
Tufan	तूफ़ान
Tuhin	तूहीन
Tuhinsurra	तुहिनसुर्रा
Tuka	तुका
Tukaram	तुकाराम
Tula	तुला
Tulasidas	तुलसीदास
Tulsidas	तुलसीदास
Tulsikumar	तुलसिकुमार
Tunava	तुनावा
Tunda	तुन्दा
Tunganath	तुंगनाथ
Tungar	तुन्गार
Tungesh	तुंगेश
Tungeshwar	तुन्गेश्वर
Tungish	तुंगिश
Turag	तुरग
Turanyu	तुरान्यु
Turvasu	तुर्वासु
Tushar	तुषार
Tusharkanti	तुषार कांति
Tusharsuvra	तुशार्सुवरा
Tusya	तुस्य
Tuvidyumna	तुविद्युमना
Tuvijat	तुविजात
Tyagaraj	त्यागराज
Tyagraja	त्याग राजा
Taahira	ताहिरा
Tabassum	तबस्सुम
Tabasumm	तबसुम्म
Taj	ताज
Talika	तालिका
Talikha	तालीखा
Talli	तल्ली
Tamadhur	तमाधुर
Tamali	तमाली
Tamalika	तमालिका
Tamanna	तमन्ना
Tamasa	तमसा
Tamasi	तमसी
Tamasvini	तामास्विनी
Tambura	तंबूरा
Tamira	तमिरा
Tanaya	तानाया
Tanaz	तनाज़
Taneesha	तनीशा
Tania	तानिया
Tanika	तानिका
Tanima	तानीमा
Tanirika	तानिरिका
Tanisha	तनीशा
Tanisi	तनिसी
Tanmaya	तन्माया
Tanmayee	तन्मयी
Tanmayi	तन्मायी
Tannishtha	तन्निष्ठा
Tannistha	तन्निस्था
Tanseem	तनसीम
Tanu	तनु
Tanuja	तनूजा
Tanuka	तनुका
Tanulata	तनुलता
Tanupa	तनुपा
Tanushi	तनुशी
Tanushri	तनुश्री
Tanusiya	तानुसिया
Tanvi	तन्वी
Tanya	तान्या
Tanzil	तन्जिल
Tapani	तपनी
Tapasi	तपसी
Tapati	तपती
Tapi	तापी
Tapni	तपनी
Tapti	ताप्ती
Tara	तारा
Tarai	तराई
Taraka	तारका
Tarakeshwari	तारकेश्वरी
Tarakini	ताराकिनी
Tarala	तरला
Tarana	तराना
Tarangini	तरंगिनी
Tarani	तरनी
Taranija	तरनीजा
Tarannum	तरन्नुम
Tarika	तारिका
Tarini	तरीनी
Tarita	तारिता
Tarjani	तर्जनी
Tarkeshwari	तारकेश्वरी
Tarla	तरला
Tarli	तरली
Tarlika	तर्लिका
Taroob	तरूब
Tarpana	तर्पना
Taru	तारू
Tarulata	तरुलता
Taruna	तरुना
Taruni	तरुणी
Tarunika	तरुनिका
Tarunima	तऋूनिमा
Tarz	तर्ज़
Tasha	तशा
Tatini	तातिनी
Tavishi	तविषी
Teertha	तीर्था
Tehzeeb	तहजीब
Teja	तेजा
Tejal	तेज़ल
Tejashree	तेजश्री
Tejasvi	तेजस्वी
Tejaswi	तेजस्वी
Tejaswini	तेजस्विनी
Teji	तेजी
Thamarai	थमाराई
ThamilSelvi	तामिलसेल्वी
Thanaa	थाना
Thaneesha	थानीषा
Tharaa	तहरा
ThenMoli	थेन्मोली
Thenral	थेंरल
Thulasi	तुलसी
Thumri	ठुमरी
Thuraya	थुराया
Tibna	तिब्ना
Tilaka	तिलका
Tilika	तिलिका
Tilottama	तिलोत्तमा
Timila	तीमिला
Tina	टीना
Tista	तीस्ता
Tisya	तिस्या
Tithi	तिथि
Titiksha	तितिक्षा
Tiya	तिया
Toral	तोरल
Toshani	तोशानी
Toya	तोया
Trariti	त्रृति
Trayi	तराई
Treya	त्रेया
Triambika	त्रिंबिका
Tribhuvaneshwari	त्रिभुवनेश्वरी
Tridhara	त्रिधरा
Tridiva	त्रिदिवा
Triguna	त्रिगूना
Triguni	त्रीगूनी
Trijagati	त्रिजगति
Trikaya	त्रिकाया
Trilochana	त्रिलोचना
Trinayani	त्रिनयनी
Trinetra	त्रिनेत्र
Triparna	त्रिपर्ना
Tripta	त्रिप्ता
Tripti	तृप्ति
Tripura	त्रिपुरा
Tripurasundari	त्रिपुरसुंदरी
Tripuri	त्रिपुरी
Triputa	त्रिपुता
Trisha	तृषा
Trishala	त्रिशाला
Trishna	त्रिष्णा
Trishona	त्रिशोना
Trishulini	त्रिशुलिनी
Triti	त्रिती
Triveni	त्रिवेणी
Triya	त्रिया
Triyama	त्रियमा
Trupti	तृप्ति
Trusha	तृषा
Tuhi	तुही
Tuhina	तूहीना
Tulasi	तुलसी
Tulika	तुलिका
Tulsi	तुलसी
Tulya	तुल्या
Turanya	तुरन्या
Turvi	तुर्वी
Turya	तुर्या
Tusharkana	तुशारकाना
Tushita	तुशिता
Tusti	तुस्ती
Tvarika	त्वारीका
Tvarita	त्वरिता
Tvesa	त्वेसा
Tvisha	तविषा

adah	उबादः
Ubaidah	उबैदाह
Ubay	उबय
Udar	उदार
Uday	उदय
Udayachal	उदयाचल
Udayan	उदयन
Udayasooriyan	उदयसूरियाँ
Uddhar	उद्धार
Uddhav	उद्धव
Udeep	उदीप
Udit	उदित
Udyam	उद्यम
Udyan	उदयन
Ujagar	उजागर
Ujala	उजाला
Ujesh	उजेश
Ujwal	उज्वल
Ulagan	उलगन
Ulagappan	उलगाप्पन
Ulhas	उल्हास
Umaarah	उमारह
Umair	उमिर
Umanand	उमानंद
Umang	उमंग
Umaprasad	उमाप्रसाद
Umar	उमर
Umashankar	उमाशंकर
Umed	उमेद
Umesh	उमेश
Umrao	ओमराव
Unmaivilambi	उनमाइवीलंबी
Unmesh	उन्मेश
Unnat	उन्नत
Upagupta	उपागुप्ता
Upamanyu	उपमन्यु
Upendra	उपेन्द्र
Uqbah	उक्बह
Urjita	उर्जीता
Usaamah	उसामः
Usama	उसमा
Ushakanta	उषा कांता
Usman	ओस्मन
Utanka	उतंका
Utbah	उत्बह
Utkarsh	उत्कर्ष
Utkarsha	उत्कर्षा
Utpal	उत्पल
Utsav	उत्सव
Uttal	उत्तल
Uttam	उत्तम
Uttar	उत्तर
Uttiya	उत्तिया
Ubika	उबिका
Ucchal	उच्चल
Udantika	उदान्तिका
Udaya	उदया
Udbala	उदबला
Udgita	उद्गिता
Udichi	उदीची
Udipti	उदिप्ती
Udita	उदीता
Uditi	उदीती
Udyati	उदयति
Ujas	उजास
Ujhala	उज्हाला
Ujjanini	उज्जानिनी
Ujjayini	उज्जयिनी
Ujjwala	उज्जवाला
Ujjwala	उज्ज्वला
Ujwala	उज्वाला
Ulka	उल्का
Ullupi	उल्लुपी
Ulupi	उलुपी
Uma	उमा
Umika	उमिका
Umm-e-abeeha	उम्म-ऐ-अबीहा
Umm-ul-banin	उम्म-उल-बनीं
Umrao	उमराव
Unma	उन्मा
Unnati	उन्नति
Unni	उन्नी
Upada	उपदा
Upala	उपाला
Upama	उपमा
Upasana	उपासना
Ura	यूरा
Urishilla	उरिशिल्ला
Urishita	उरिशिता
Urja	उर्जा
Urmi	उर्मी
Urmika	उर्मिका
Urmila	उर्मिला
Urmimala	उर्मिमाला
Urna	अर्ना
Urshita	उर्शिता
Urvashi	उर्वशी
Urvasi	उर्वसी
Urvi	उर्वी
Usha	उषा
Ushakiran	उषाकिरण
Ushalakshi	उशालाक्षी
Ushashi	उषाशि
Ushi	उशी
Ushma	उष्मा
Ushta	उश्ता
Usra	उस्रा
Usri	उसरी
Utalika	उतालिका
Uthami	उथामी
Utpala	उत्पल
Utpalakshi	उत्पलाक्षी
Utpalini	उत्पालिनी
Utpatti	उत्पत्ति
Utsa	उत्सा
Utsavi	उत्सवी
Uttara	उत्तरा
Vaasavadatta	वासवादात्ता
Vachan	वचन
Vachaspati	वाचस्पति
Vadin	वादीन
Vadish	वादिश
Vagesh	वागीश
Vagindra	वागिन्द्र
Vagish	वागीश
Vahin	वहीं
Vaibhav	वैभव
Vaidyanath	वैद्यनाथ
Vaijayi	विजयी
Vaijnath	वैजनाथ
Vaikartan	वैकर्तन
Vaikhan	वैखन
Vaikunth	वैकुंठ
Vaikunth-nath	वैकुण्ठ-नाथ
Vainavin	वैनाविन
Vairaj	विराज
Vairaja	विरजा
Vairat	विरत
Vairinchya	वैरिंच्या
Vairochan	वैरोचन
Vaisaka	वैसका
Vaishant	वैशंत
Vaishwanar	वैश्वानर
Vaiwaswat	वैवस्वत
Vajasani	वजसनी
Vajendra	वजेंद्र
Vajra	वज्र
Vajrabahu	वज्रबाहू
Vajradhar	वज्राधर
Vajrahast	वज्रहस्त
Vajrajit	वज्राजित
Vajrakaya	वज्राकाया
Vajraksha	वज्रक्षा
Vajramani	वज्रमानी
Vajrang	वजरांग
Vajrapani	वज्रपानी
Vajrin	वज्रिन
Vakpati	वाक्पति
Vakrabhuj	वक्रभुज
Vakratund	वक्रतुण्ड
Valak	वलाक
Valavan	वलावन
Vallabh	वल्लभ
Valmeki	वाल्मीकि
Valmik	वाल्मीकि
Valmiki	वाल्मीकि
Vamadev	वामदेव
Vaman	वामन
Vamdev	वामदेव
Vamsi	वाम्सी
Vamsidhar	वाम्सिधर
Vamsikrishna	वंसिकृष्ण
Vanabihari	वनाबिहारी
Vanad	वनद
Vanadev	वनदेव
Vanajit	वनजीत
Vanamalin	वनामलिन
Vandan	वंदन
Vani	वाणी
Vanij	वनिज
Vaninadh	वनिनाध
Vaninath	वानिनाथ
Vanmali	वनमाली
Van-raj	वन-राज
Vansh	वंश
Vansheedhar	वंशीधर
Vanshya	वन्ष्य
Varad	वरद
Varadaraj	वरदराज
Varah	वराह
Varahamihir	वराहमिहिर
Vardhaman	वर्धमान
Vardhan	वर्धन
Varendra	वरेन्द्र
Varesh	वरेष
Vareshvar	वरेश्वर
Varid	वारिद
Varidhvaran	वारिध्वरण
Varij	वारिज़
Varin	वरिन
Varindra	वरिन्द्र
Varish	वारीश
Variya	वरिया
Variyas	वरियास
Vartanu	वर्ताणु
Varun	वरुण
Varunesh	वरुनेश
Vasant	वसंत
Vasantamalika	वासंतामालिका
Vasav	वासव
Vasava	वासवा
Vasavaj	वासवज
Vashisht	वशिष्ट
Vasistha	वसिस्ठा
Vasu	वासू
Vasudev	वासुदेव
Vasuki	वासुकी
Vasuman	वासुमन
Vasumat	वसुमत
Vasumitr	वसुमित्र
Vasupati	वसुपति
Vasur	वसुर
Vasuroop	वसुरूप
Vasusen	वसुसेन
Vatatmaj	वातत्माज
Vatradhara	वत्रधरा
Vatsa	वत्स
Vatsal	वत्सल
Vatsapal	वत्सपल
Vatsar	वत्सर
Vatsin	वत्सिन
Vatsyayan	वात्स्यायन
Vaydeesh	वयदीश
Vayu	वायु
Vayujat	वयुजत
Vayun	वायुन
Vayunand	वयुनंद
Vayya	वय्या
Ved	वेद
Vedanga	वेदांगा
Vedant	वेदांत
Vedaprakash	वेदप्रकाश
Vedatman	वेदात्मन
Vedatmane	वेदात्मने
Vedavrata	वेदव्रता
Vedbhushan	वेदभुशन
Vedesh	वेदेश
Vedmohan	वेद मोहन
Vedprakash	वेदप्रकाश
Ved-vyas	वेद-व्यास
Veekshith	वीक्षिथ
Veer	वीर
Veera	वीरा
Veerbhadra	वीरभद्र
Veerendra	वीरेंद्र
Veerottam	वीरोत्तम
Velan	वेलन
Venavir	वेनाविर
Vendan	वेंदन
Vengai	वेंगाई
Veni	वेनी
Venimadhav	वेनिमाधव
Venkat	वेंकट
Venkataramananandan	वेंकतारामानानान्दन
Venkatesh	वेंकटेश
Venu	वेणु
Venugopal	वेणुगोपाल
Venumadhav	वेनुमाधव
Vetrival	वेत्रिवाल
Veydant	वेदान्त
Viamrsh	वियामर्श
Vibhakar	विभाकर
Vibhas	विभास
Vibhat	विभात
Vibhavasu	विभावासु
Vibhishan	विभीशन
Vibhor	विभोर
Vibhu	विभू
Vibhumat	विभुमत
Vibhusnu	विभुस्णु
Vibhut	विभुत
Vibodh	विबोध
Vidarbh	विदर्भ
Videh	विदेह
Vidhatru	विधात्रू
Vidhesh	विधेश
Vidhu	विधु
Vidhyadhar	विद्याधर
Vidip	विदिप
Vidit	विदित
Vidojas	विदोजास
Vidur	विदूर
Vidvan	विद्वान्
Vidvatam	विद्वातम
Vidyacharan	विद्याचरण
Vidyadhar	विद्याधर
Vidyaranya	विद्यारान्य
Vidyasagar	विद्यासागर
Vidyut	विद्युत
Vighnajit	विघ्नाजित
Vighnaraj	विघ्नाराज
Vighnesh	विगनेश
Vighneshwar	विघ्नेश्वर
Vigrah	विग्रह
Vihan	विहान
Vihang	विहंग
Vihanga	विहंगा
Vijay	विजय
Vijayant	विजयंत
Vijayarathna	विजयाराथ्ना
Vijayendra	विजयेन्द्र
Vijayesh	विजयेश
Vijayketu	विजयकेतु
Vijender	विजेंदर
Vijendra	विजेंद्र
Vijigeesh	विजीगीश
Vijval	विज्वल
Vikarnan	विकर्नन
Vikas	विकास
Vikat	विकात
Vikern	विकर्ण
Vikesh	विकेश
Vikram	विक्रम
Vikramaditya	विक्रमादित्य
Vikramajit	विक्रमाजीत
Vikramendra	विक्रमेन्द्र
Vikramin	विक्रमिन
Vikrant	विक्रांत
Vikranta	विक्रांता
Viksar	विकसर
Vikunth	विकुंठ
Vilas	विलास
Vilochan	विलोचन
Vilohit	विलोहित
Vilok	विलोक
Vilokan	विलोकन
Vimal	विमल
Vimaladitya	विमलादित्य
Vimalmani	विमलमानी
Vimridh	विमृध
Vinahast	विनाहस्त
Vinamr	विनम्र
Vinay	विनय
Vinayak	विनायक
Vineet	विनीत
Vinesh	विनेश
Vinil	विनिल
Vinochan	विनोचन
Vinod	विनोद
Vinoo	विनू
Vipan	विपन
Vipaschit	विपश्चित
Vipin	विपिन
Vipinbehari	विपिनबेहरी
Viplab	विप्लब
Viplav	विप्लव
Vipra	विप्रा
Vipreet	विपरीत
Vipul	विपुल
Vir	वीर
Virabhadra	वीरभद्र
Viraj	विराज
Viral	विरल
Viranath	विरनाथ
Viranchi	विरांची
Virasana	विरासना
Virat	विराट
Virbhanu	विरभानु
Virendra	वीरेन्द्र
Viresh	विरेश
Vireshvar	वीरेश्वर
Virikvas	विरीक्वास
Virinchi	विरिंची
Virochan	विरोचन
Virudh	विरुद्ध
Virurch	विरुर्च
Visamaksh	विसमक्ष
Vishakh	विशाख
Vishal	विशाल
Vishalaksh	विशालाक्ष
Vishalya	विशल्य
Vishantak	विशान्तक
Vishatan	विशातन
Vishesh	विशेष
Vishikh	विशिख
Vishnahpu	विश्नाह्पू
Vishnu	विष्णु
Vishnudutt	विश्नुदुत्त
Vishodhan	विशोधन
Vishram	विश्राम
Vishresh	विश्रेश
Vishruth	विश्रुथ
Vishtasp	विश्तास्प
Vishv	विश्व
Vishva	विश्वा
Vishvadev	विश्वदेव
Vishvadhar	विश्वधर
Vishvag	विश्वाग
Vishvahetu	विश्वहेतु
Vishvajit	विश्वजीत
Vishvakarma	विश्वकर्मा
Vishvaketu	विश्वकेतु
Vishvam	विश्वम
Vishvamitra	विश्वामित्र
Vishvanabh	विश्वनाभ
Vishvanath	विश्वनाथ
Vishvaretas	विश्वरेतस
Vishvatma	विश्वात्मा
Vishvesh	विश्वेश
Vishwajeet	विश्वजीत
Vishwakarma	विश्वकर्मा
Vishwambhar	विश्वम्भर
Vishwamitra	विश्वामित्र
Vishwanath	विश्वनाथ
Vishwankar	विश्वंकर
Vishwaroop	विश्वरूप
Vishwas	विश्वास
Vishwatma	विश्वात्मा
Vishwesh	विश्वेष
Vishweshwar	विश्वेश्वर
Vismay	विस्मय
Visvajit	विस्वजित
Visvayu	विस्वायु
Viswanath	विस्वनाथ
Viswas	विश्वास
Vitabhay	विताभय
Vitaharya	विताहार्य
Vitashokha	विताशोखा
Vitasta	वितास्ता
Vithala	विठाला
Vitola	वितोला
Vittanath	वित्तानाथ
Vittesh	वित्तेश
Vitthal	विथाला
Vivash	विवश
Vivaswat	विवास्वत
Vivatma	विवात्मा
Vivek	विवेक
Vivekananda	विवेकानंदा
Vrajakishore	व्रजकिशोरे
Vrajalal	वृजलाल
Vrajamohan	वृजमोहन
Vrajanadan	व्रजनादन
Vrajesh	व्रजेश
Vrajraj	व्रजराज
Vratesh	व्रतेश
Vrisa	वृसा
Vrisag	वृसग
Vrisan	वृसन
Vrisangan	वृसंगन
Vrisapati	वृसपति
Vrishab	वृस्हब
Vrishabh	वृषभ
Vrishabhanu	वृषभानु
Vrishank	वृशंक
Vrishin	वृषिन
Vrisini	वृसिनी
Vyan	व्यान
Vyasa	व्यासा
Vyom	व्योम
Vyomakesh	व्योमकेश
Vyomang	व्योमांग
Vyomdev	व्योमदेव
Vyomesh	व्योमेश
Vyshnav	व्यश्नव
Vachya	वाच्य
Vagdevi	वगदेवी
Vagishwari	वागीश्वरी
Vahini	वाहिनी
Vaidarbhi	वैदर्भी
Vaidehi	वैदेही
Vaijayanti	वैजयंती
Vaijayantimala	वैजयंतीमाला
Vainavi	वैनावी
Vaisakhi	वैसाखी
Vaishali	वैशाली
Vaishavi	वैशावी
Vaishnavi	वैष्णवी
Vaishnodevi	वैशावी
Vajra	वज्रा
Vajreshwari	वज्रेश्वरी
Valini	वालिनी
Vallabha	वल्लभा
Vallari	वल्लरी
Valli	वल्ली
Vallika	वल्लिका
Vama	वामा
Vamakshi	वामाक्षी
Vamdevi	वामदेवी
Vamika	वामीका
Vamil	वामील
Vamita	वामीता
Vanadurga	वानादुर्गा
Vanaja	वनजा
Vanalika	वानलिका
Vanamala	वनमाला
Vanani	वनानी
Vanathi	वनाथी
Vanca	वांका
Vandana	वंदना
Vandita	वन्दिता
Vaneesha	वनीषा
Vaneet	वनीत
Vanhi	वंही
Vanhishikha	वंहिशिखा
Vani	वाणी
Vania	वनिया
Vanika	वानिका
Vanini	वनिनी
Vanishri	वानिश्री
Vanita	वनिता
Vanjan	वंजन
Vanmala	वनमाला
Vanmalli	वनमल्ली
Vanmayi	वन्मई
Vanshi	वंशी
Vanshika	वंशिका
Vara	वारा
Varada	वरदा
Varali	वरली
Varalika	वरालिका
Varana	वारना
Varda	वरदा
Vari	वारी
Varija	वारीज़ा
Varnika	वर्णिका
Varnu	वरनु
Varsha	वर्षा
Varshana	वर्षाना
Varshini	वर्शिनी
Vartika	वर्तिका
Varuna	वरुना
Varunavi	वरुनावी
Varuni	वारुणी
Varunika	वरुनिका
Varya	वार्या
Vasana	वासना
Vasanta	वसंता
Vasantaprabha	वासंताप्रभा
Vasanti	वसंती
Vasantika	वसंतिका
Vasatika	वसतिका
Vasavi	वसवी
Vashnie	वश्निए
Vasuda	वसुदा
Vasudeva	वासुदेव
Vasudha	वसुधा
Vasudhara	वसुधारा
Vasudharini	वसुधारिणी
Vasulakshmi	वसुलक्ष्मी
Vasumati	वसूमति
Vasundhara	वसुंधरा
Vati	वती
Vatsala	वत्सला
Veda	वेदा
Vedanti	वेदान्ती
Vedha	वेधा
Vedi	वेदी
Vedika	वेदिका
Vedvalli	वेदवल्ली
Veeksha	वीक्षा
VeeraSundari	वीरा सुंदरी
Vela	वेला
Venah	वेनाह
Venika	वेनिका
Vennela	वेन्नेला
Venuka	वेनुका
Venya	वेन्या
Vetali	वेताली
Vetravati	वेत्रवती
Vibali	विबाली
Vibha	विभा
Vibhavari	विभावारी
Vibhi	विभी
Vibhuti	विभूति
Vibusha	विबुषा
Vidhi	विधि
Vidhut	विधुत
Vidisha	विदिशा
Vidita	विदिता
Vidula	विदुला
Vidushi	विदुषी
Vidya	विद्या
Vidyadevi	विद्यादेवी
Vidyadhari	विद्याधारी
Vidyul	विद्युल
Vidyut	विद्युत
Vidyutprabha	विद्युतप्रभा
Vijaya	विजया
Vijayalakshmi	विजयालक्ष्मी
Vijayanthi	विजयंथी
Vijeta	विजेता
Vijul	विजुल
Vikasni	विकास्नी
Vikruti	विकृति
Vilasini	विलासिनी
Vilina	विलिना
Vimala	विमला
Vimla	विमला
Vimudha	विमुधा
Vina	विना
Vinamra	विनम्र
Vinanti	विनंती
Vinapani	वीनापनी
Vinata	विनता
Vinati	विनति
Vinaya	विनया
Vindhya	विंध्या
Vineeta	विनीता
Vinita	विनीता
Vinoda	विनोदा
Vinodini	विनोदिनी
Vinutha	विनुथा
Vipanchi	विपांची
Vipasa	वीपासा
Vipasha	विपाशा
Vipula	विपुला
Virata	विराता
Virendri	विरेन्द्री
Virika	विरिका
Virini	विरिनी
Visala	विसाला
Vishaka	विशाका
Vishakha	विशाखा
Vishala	विशाला
Vishalakshi	विशालाक्षी
Vishali	विशाली
Vishalya	विशाल्या
Vishaya	विषया
Vishma	विष्मा
Vishnumaya	विष्णुमाया
Vishnupriya	विष्णुप्रिया
Vishranti	विश्रांति
Vishwa	विश्वा
Vismaya	विस्मय
Vistarini	विस्तारिणी
Vithika	वीथिका
Viti	विती
Viveka	विवेका
Vividha	विविधा
Vrajabala	व्रजबाला
Vrinda	वृंदा
Vrisha	वृषा
Vrishti	वृष्टि
Vritee	वृती
Vritika	वृतिका
Vritti	वृत्ति
Vrushali	वृशाली
Vyanjana	व्यंजना
Vyjayanti	व्य्जयंती
Vyomini	व्योमिनी

Waahid	वाहिद
Wadee	वादी
Wadee	वादी
Wafeeq	वाफीक
Wajeeh	वज़ीह
Waleed	वालीद
Wali	वाली
Waliyudeen	वालियुदीन
Waliyullah	वालियुल्लाह
Walleed	वाल्लीद
Waman	वामन
Wasan	वासन
Waseem	वासीम
Wyconda	व्य्कोन्दा
Wafa	वफ़ा
Wafeeqa	वाफीका
Wafiya	वाफिया
Waheeda	वहीदा
Wajeeha	वजीहा
Wamika	वामीका
Wamil	वामिल
Warda	वरदा
Wateeb	वातीब
Widad	विदाद
Wijdan	विज्दान
Wisaal	विसाल
Yaaseen	यासीन
Yadav	यादव
Yadavendra	यादवेन्द्र
Yadu	यदु
Yadunandan	यदुनंदन
Yadunath	यदुनाथ
Yaduraj	यदुराज
Yaduvir	यदुवीर
Yagna	यग्ना
Yagnesh	यज्नेश
Yagya	यज्ञ
Yagyasen	यज्ञसेन
Yagyesh	यज्येश
Yahyaa	याह्या
Yaj	यज
Yajat	यजत
Yajnadhar	यजनाधर
Yajnarup	यज्नारूप
Yajnesh	यजनेश
Yaksha	यक्ष
Yamahil	यमहिल
Yamajit	यमजित
Yamajith	यमाजिथ
Yaman	यमन
Yamir	यामिर
Yasaar	यासार
Yash	यश
Yashas	यशस
Yashmit	यश्मित
Yashodev	यशोदेव
Yashodhan	यशोधन
Yashodhar	यशोधर
Yashodhara	यशोधरा
Yashovardhana	यशोवर्धना
Yashovarman	यशोवर्मन
Yashpal	यशपाल
Yashpal	यशपाल
Yashvasin	यश्वसिं
Yashwant	यशवंत
Yasir	यासिर
Yasti	यस्ती
Yathavan	यथावन
Yatin	यतीन
Yatindra	यतींद्र
Yatish	यतीश
Yatiyasa	यातियासा
Yatnesh	यत्नेश
Yayati	ययाति
Yayin	याईन
Yazeed	याजीद
Yogadeva	योगदेवा
Yoganand	योगानंद
Yoganidra	योगनिद्रा
Yogendra	योगेंद्रा
Yogesh	योगेश
Yogi	योगी
Yoginampati	योगिनाम्पति
Yogine	योगिने
Yogiraj	योगिराज
Yojit	योजित
Yoonus	यूनुस
Yoosuf	यूसुफ
Yudhajit	युधाजित
Yudhisthir	युधिसठिर
Yugandhar	युगान्धर
Yugantar	युगान्तर
Yugma	युग्म
Yukta	युक्ता
Yuval	युवल
Yuvaraj	युवराज
Yuyutsu	युयुत्सु
Yachana	याचना
Yadavi	यादवी
Yafiah	याफीः
Yagnya	यागन्या
Yahvi	याह्वी
Yajna	याज्ना
Yakootah	याकूतः
Yaksha	यक्षा
Yalini	यालिनी
Yalisai	यालीसाई
Yamha	यामहा
Yamika	यामिका
Yamini	यामिनी
Yamuna	यमुना
Yamuni	यामुनी
Yamura	यामुरा
Yamya	यम्या
Yashasvi	यशस्वी
Yashasvini	यशस्विनी
Yashawanthi	यशवंती
Yashawini	यशविनी
Yashica	यशिका
Yashila	यशीला
Yashita	यशिता
Yashmita	यश्मिता
Yashoda	यशोदा
Yashomati	यशोमती
Yasirah	यासिरह
Yasmeen	यास्मीन
Yasmin	यस्मिन
Yasti	यस्ती
Yatudhani	यातुधानी
Yauvani	यौवानी
Yayati	ययाति
Yema	एमा
Yochana	योचना
Yogeshwari	योगेश्वरी
Yogini	योगिनी
Yogita	योगिता
Yogya	योग्य
Yonita	योनिता
Yosana	योसना
Yoshita	योशिता
Yousha	यौषा
Yuktha	युक्ता
Yukti	युक्ति
Yumn	युमं
Yusraa	युसरा
Yuthika	युथिका
Yuti	युति
Yutika	युतिका
Yuvati	युवती
Yuvika	यूविका
Yuvrani	युवरानी
Zaafir	जाफिर
Zaahid	जाहिद
Zaahir	ज़ाहिर
Zahin	ज़हीन
Zaid	जैद
Zaiden	जैदेन
Zaigham	जैघम
Zakariya	ज़करिया
Zakir	जाकिर
Zakiy	जाकीय
Zalman	ज़लमन
Zashil	जाशील
Zayd	ज़यद
Zayyan	ज़य्यन
Zeeshan	जीशन
Zev	जेव
Zikomo	जिकोमो
Ziyad	जियाद्क
Zohaib	जोहैब
Zola	जोला
Zosar	जोसर
Zuhair	ज़ुहैर
Zuhayr	ज़ुहयर
Zaafira	जाफिरा
Zahbia	ज़हबिया
Zahira	जाहिरा
Zahraa	ज़हरा
Zahrah	ज़हरः
Zaida	जैदा
Zaina	जैना
Zainab	जैनाब
Zakiyaa	ज़किया
Zankhana	जंखना
Zarna	ज़रना
Zeenat	जीनत
Zehba	ज़ह्बा
Zena	जेना
Zerah	ज़रह
Zerelda	जेरेल्दा
Zia	जिया
Ziana	जिअना
Zohra	जोहरा
Zueinah	ज़ुएइनह्
Zuha	जुहा
Zuleika	ज़ुलेइका
Zulema	ज़ुलेमा
Zuleyka	ज़ुलेयका
Zunaira	ज़ुनैरा
